Województwo,code,Gmina,Powiat,registered_voters,ballots_cast,valid_votes,kaczyński,komorowski
dolnośląskie,20101,"Bolesławiec, m.",bolesławiecki,32799,17529,17356,6083,11273
dolnośląskie,20102,"Bolesławiec, gm.",bolesławiecki,10377,5108,5051,2146,2905
dolnośląskie,20103,"Gromadka, gm.",bolesławiecki,4386,2096,2071,1021,1050
dolnośląskie,20104,"Nowogrodziec, gm.",bolesławiecki,11764,4995,4939,2247,2692
dolnośląskie,20105,"Osiecznica, gm.",bolesławiecki,5244,2305,2281,822,1459
dolnośląskie,20106,"Warta Bolesławiecka, gm.",bolesławiecki,6436,2831,2802,1227,1575
dolnośląskie,20201,"Bielawa, m.",dzierżoniowski,26251,12386,12218,4522,7696
dolnośląskie,20202,"Dzierżoniów, m.",dzierżoniowski,28763,15107,14946,5429,9517
dolnośląskie,20203,"Pieszyce, m.",dzierżoniowski,7744,3556,3506,1519,1987
dolnośląskie,20204,"Piława Górna, m.",dzierżoniowski,5342,2457,2430,1098,1332
dolnośląskie,20205,"Dzierżoniów, gm.",dzierżoniowski,7738,3764,3731,1806,1925
dolnośląskie,20206,"Łagiewniki, gm.",dzierżoniowski,6153,2779,2748,1400,1348
dolnośląskie,20207,"Niemcza, gm.",dzierżoniowski,4908,2304,2291,932,1359
dolnośląskie,20301,"Głogów, m.",głogowski,55295,29850,29446,14162,15284
dolnośląskie,20302,"Głogów, gm.",głogowski,4595,2351,2329,1272,1057
dolnośląskie,20303,"Jerzmanowa, gm.",głogowski,2875,1565,1547,871,676
dolnośląskie,20304,"Kotla, gm.",głogowski,3246,1415,1393,805,588
dolnośląskie,20305,"Pęcław, gm.",głogowski,1785,896,874,513,361
dolnośląskie,20306,"Żukowice, gm.",głogowski,2737,1187,1172,630,542
dolnośląskie,20401,"Góra, gm.",górowski,16464,7343,7282,3016,4266
dolnośląskie,20402,"Jemielno, gm.",górowski,2482,1062,1050,536,514
dolnośląskie,20403,"Niechlów, gm.",górowski,3988,1691,1675,880,795
dolnośląskie,20404,"Wąsosz, gm.",górowski,5888,2393,2360,1107,1253
dolnośląskie,20501,"Jawor, m.",jaworski,19975,10225,10125,4438,5687
dolnośląskie,20502,"Bolków, gm.",jaworski,8977,4082,4024,1575,2449
dolnośląskie,20503,"Męcinka, gm.",jaworski,3801,1659,1649,938,711
dolnośląskie,20504,"Mściwojów, gm.",jaworski,3259,1579,1564,752,812
dolnośląskie,20505,"Paszowice, gm.",jaworski,3111,1374,1353,709,644
dolnośląskie,20506,"Wądroże Wielkie, gm.",jaworski,3213,1313,1307,630,677
dolnośląskie,20601,"Karpacz, m.",jeleniogórski,5543,3575,3537,970,2567
dolnośląskie,20602,"Kowary, m.",jeleniogórski,9684,4950,4896,1475,3421
dolnośląskie,20603,"Piechowice, m.",jeleniogórski,5417,2882,2852,954,1898
dolnośląskie,20604,"Szklarska Poręba, m.",jeleniogórski,6942,4056,4019,1185,2834
dolnośląskie,20605,"Janowice Wielkie, gm.",jeleniogórski,3591,1741,1725,534,1191
dolnośląskie,20606,"Jeżów Sudecki, gm.",jeleniogórski,5250,2596,2571,829,1742
dolnośląskie,20607,"Mysłakowice, gm.",jeleniogórski,8119,4005,3957,1369,2588
dolnośląskie,20608,"Podgórzyn, gm.",jeleniogórski,6739,3561,3525,1085,2440
dolnośląskie,20609,"Stara Kamienica, gm.",jeleniogórski,4233,1952,1928,659,1269
dolnośląskie,20701,"Kamienna Góra, m.",kamiennogórski,17260,8757,8655,3139,5516
dolnośląskie,20702,"Kamienna Góra, gm.",kamiennogórski,6893,3447,3395,1347,2048
dolnośląskie,20703,"Lubawka, gm.",kamiennogórski,9331,4634,4537,1552,2985
dolnośląskie,20704,"Marciszów, gm.",kamiennogórski,3729,1701,1681,664,1017
dolnośląskie,20801,"Duszniki-Zdrój, m.",kłodzki,4671,2550,2524,951,1573
dolnośląskie,20802,"Kłodzko, m.",kłodzki,23749,12314,12178,4380,7798
dolnośląskie,20803,"Kudowa-Zdrój, m.",kłodzki,9483,5392,5338,2175,3163
dolnośląskie,20804,"Nowa Ruda, m.",kłodzki,19901,9448,9369,3082,6287
dolnośląskie,20805,"Polanica-Zdrój, m.",kłodzki,6540,3633,3594,1311,2283
dolnośląskie,20806,"Bystrzyca Kłodzka, gm.",kłodzki,16510,8226,8130,3421,4709
dolnośląskie,20807,"Kłodzko, gm.",kłodzki,13838,6325,6243,2789,3454
dolnośląskie,20808,"Lądek-Zdrój, gm.",kłodzki,7964,4199,4150,1632,2518
dolnośląskie,20809,"Lewin Kłodzki, gm.",kłodzki,1659,754,752,376,376
dolnośląskie,20810,"Międzylesie, gm.",kłodzki,6221,2970,2936,981,1955
dolnośląskie,20811,"Nowa Ruda, gm.",kłodzki,10086,4539,4498,1663,2835
dolnośląskie,20812,"Radków, gm.",kłodzki,7894,3685,3656,1567,2089
dolnośląskie,20813,"Stronie Śląskie, gm.",kłodzki,6289,2918,2878,935,1943
dolnośląskie,20814,"Szczytna, gm.",kłodzki,6071,2756,2735,963,1772
dolnośląskie,20901,"Chojnów, m.",legnicki,11580,5555,5485,2325,3160
dolnośląskie,20902,"Chojnów, gm.",legnicki,7437,3217,3189,1630,1559
dolnośląskie,20903,"Krotoszyce, gm.",legnicki,2427,1205,1191,652,539
dolnośląskie,20904,"Kunice, gm.",legnicki,4433,2373,2344,971,1373
dolnośląskie,20905,"Legnickie Pole, gm.",legnicki,3788,1870,1835,910,925
dolnośląskie,20906,"Miłkowice, gm.",legnicki,4970,2602,2571,1181,1390
dolnośląskie,20907,"Prochowice, gm.",legnicki,5919,2816,2774,1211,1563
dolnośląskie,20908,"Ruja, gm.",legnicki,2142,943,923,433,490
dolnośląskie,21001,"Lubań, m.",lubański,18382,9361,9255,3254,6001
dolnośląskie,21002,"Świeradów-Zdrój, m.",lubański,4155,2179,2153,767,1386
dolnośląskie,21003,"Leśna, gm.",lubański,8433,3881,3844,1537,2307
dolnośląskie,21004,"Lubań, gm.",lubański,5064,2240,2210,884,1326
dolnośląskie,21005,"Olszyna, gm.",lubański,5365,2349,2319,869,1450
dolnośląskie,21006,"Platerówka, gm.",lubański,1298,633,623,324,299
dolnośląskie,21007,"Siekierczyn, gm.",lubański,4071,2013,1986,791,1195
dolnośląskie,21101,"Lubin, m.",lubiński,60774,32856,32520,17499,15021
dolnośląskie,21102,"Lubin, gm.",lubiński,9950,5186,5117,2752,2365
dolnośląskie,21103,"Rudna, gm.",lubiński,5816,2909,2879,1834,1045
dolnośląskie,21104,"Ścinawa, gm.",lubiński,8327,4162,4112,2568,1544
dolnośląskie,21201,"Gryfów Śląski, gm.",lwówecki,8266,3792,3739,1432,2307
dolnośląskie,21202,"Lubomierz, gm.",lwówecki,4978,2182,2148,843,1305
dolnośląskie,21203,"Lwówek Śląski, gm.",lwówecki,14298,6873,6807,2495,4312
dolnośląskie,21204,"Mirsk, gm.",lwówecki,7288,3195,3147,1363,1784
dolnośląskie,21205,"Wleń, gm.",lwówecki,3705,1801,1779,697,1082
dolnośląskie,21301,"Cieszków, gm.",milicki,3690,1648,1630,789,841
dolnośląskie,21302,"Krośnice, gm.",milicki,6252,2855,2816,1470,1346
dolnośląskie,21303,"Milicz, gm.",milicki,19448,9558,9442,4092,5350
dolnośląskie,21401,"Oleśnica, m.",oleśnicki,29602,16704,16509,6174,10335
dolnośląskie,21402,"Bierutów, gm.",oleśnicki,8107,3604,3548,1589,1959
dolnośląskie,21403,"Dobroszyce, gm.",oleśnicki,4821,2322,2303,1067,1236
dolnośląskie,21404,"Dziadowa Kłoda, gm.",oleśnicki,3579,1486,1464,544,920
dolnośląskie,21405,"Międzybórz, gm.",oleśnicki,3900,1913,1889,595,1294
dolnośląskie,21406,"Oleśnica, gm.",oleśnicki,9195,4037,3987,1894,2093
dolnośląskie,21407,"Syców, gm.",oleśnicki,12957,6595,6535,2325,4210
dolnośląskie,21408,"Twardogóra, gm.",oleśnicki,10300,4743,4686,1822,2864
dolnośląskie,21501,"Oława, m.",oławski,25260,14758,14580,5783,8797
dolnośląskie,21502,"Domaniów, gm.",oławski,4098,2027,2006,1112,894
dolnośląskie,21503,"Jelcz-Laskowice, gm.",oławski,17806,9384,9286,4433,4853
dolnośląskie,21504,"Oława, gm.",oławski,11197,5916,5850,2953,2897
dolnośląskie,21601,"Chocianów, gm.",polkowicki,10125,5327,5285,3299,1986
dolnośląskie,21602,"Gaworzyce, gm.",polkowicki,2962,1527,1503,894,609
dolnośląskie,21603,"Grębocice, gm.",polkowicki,4043,1866,1854,1122,732
dolnośląskie,21604,"Polkowice, gm.",polkowicki,20127,10560,10442,5907,4535
dolnośląskie,21605,"Przemków, gm.",polkowicki,7166,3199,3164,1726,1438
dolnośląskie,21606,"Radwanice, gm.",polkowicki,3500,1676,1654,914,740
dolnośląskie,21701,"Borów, gm.",strzeliński,4208,2224,2202,1283,919
dolnośląskie,21702,"Kondratowice, gm.",strzeliński,3734,1750,1730,878,852
dolnośląskie,21703,"Przeworno, gm.",strzeliński,4110,1802,1784,938,846
dolnośląskie,21704,"Strzelin, gm.",strzeliński,18665,9830,9724,3839,5885
dolnośląskie,21705,"Wiązów, gm.",strzeliński,5944,2866,2842,1679,1163
dolnośląskie,21801,"Kostomłoty, gm.",średzki,5653,2483,2464,1325,1139
dolnośląskie,21802,"Malczyce, gm.",średzki,4751,2120,2104,955,1149
dolnośląskie,21803,"Miękinia, gm.",średzki,9935,5018,4953,2022,2931
dolnośląskie,21804,"Środa Śląska, gm.",średzki,15256,7398,7315,2943,4372
dolnośląskie,21805,"Udanin, gm.",średzki,4503,1980,1960,1030,930
dolnośląskie,21901,"Świdnica, m.",świdnicki,48779,27034,26723,9623,17100
dolnośląskie,21902,"Świebodzice, m.",świdnicki,18610,9138,8994,3360,5634
dolnośląskie,21903,"Dobromierz, gm.",świdnicki,4405,2033,2003,1122,881
dolnośląskie,21904,"Jaworzyna Śląska, gm.",świdnicki,8198,3805,3748,1775,1973
dolnośląskie,21905,"Marcinowice, gm.",świdnicki,5095,2471,2443,1261,1182
dolnośląskie,21906,"Strzegom, gm.",świdnicki,21904,10570,10443,4462,5981
dolnośląskie,21907,"Świdnica, gm.",świdnicki,12795,6193,6116,2667,3449
dolnośląskie,21908,"Żarów, gm.",świdnicki,9971,4868,4796,2156,2640
dolnośląskie,22001,"Oborniki Śląskie, gm.",trzebnicki,14876,8465,8375,3303,5072
dolnośląskie,22002,"Prusice, gm.",trzebnicki,7201,3211,3162,1719,1443
dolnośląskie,22003,"Trzebnica, gm.",trzebnicki,17650,9138,9039,3986,5053
dolnośląskie,22004,"Wisznia Mała, gm.",trzebnicki,6876,3740,3697,1708,1989
dolnośląskie,22005,"Zawonia, gm.",trzebnicki,4432,1936,1915,841,1074
dolnośląskie,22006,"Żmigród, gm.",trzebnicki,11821,5307,5256,2091,3165
dolnośląskie,22101,"Boguszów-Gorce, m.",wałbrzyski,13294,6243,6168,1845,4323
dolnośląskie,22102,"Jedlina-Zdrój, m.",wałbrzyski,4121,1990,1962,639,1323
dolnośląskie,22103,"Szczawno-Zdrój, m.",wałbrzyski,4853,3062,3033,889,2144
dolnośląskie,22104,"Czarny Bór, gm.",wałbrzyski,3822,1886,1864,748,1116
dolnośląskie,22105,"Głuszyca, gm.",wałbrzyski,7469,3382,3353,1150,2203
dolnośląskie,22106,"Mieroszów, gm.",wałbrzyski,6076,2582,2541,815,1726
dolnośląskie,22107,"Stare Bogaczowice, gm.",wałbrzyski,3354,1612,1592,604,988
dolnośląskie,22108,"Walim, gm.",wałbrzyski,4821,2124,2105,786,1319
dolnośląskie,22109,"Wałbrzych, m.",wałbrzyski,97885,47838,47122,15060,32062
dolnośląskie,22201,"Brzeg Dolny, gm.",wołowski,13074,6730,6646,2437,4209
dolnośląskie,22202,"Wińsko, gm.",wołowski,6976,3196,3163,1863,1300
dolnośląskie,22203,"Wołów, gm.",wołowski,19722,10264,10149,4209,5940
dolnośląskie,22301,"Czernica, gm.",wrocławski,8016,4877,4830,2017,2813
dolnośląskie,22302,"Długołęka, gm.",wrocławski,17066,9690,9616,4607,5009
dolnośląskie,22303,"Jordanów Śląski, gm.",wrocławski,2487,1240,1234,660,574
dolnośląskie,22304,"Kąty Wrocławskie, gm.",wrocławski,15361,8183,8094,3381,4713
dolnośląskie,22305,"Kobierzyce, gm.",wrocławski,11923,6556,6517,2520,3997
dolnośląskie,22306,"Mietków, gm.",wrocławski,3124,1552,1528,661,867
dolnośląskie,22307,"Sobótka, gm.",wrocławski,10117,5113,5065,2180,2885
dolnośląskie,22308,"Siechnice, gm.",wrocławski,12011,7200,7134,2999,4135
dolnośląskie,22309,"Żórawina, gm.",wrocławski,6867,3436,3400,1548,1852
dolnośląskie,22401,"Bardo, gm.",ząbkowicki,4604,2228,2189,931,1258
dolnośląskie,22402,"Ciepłowody, gm.",ząbkowicki,2550,1074,1058,505,553
dolnośląskie,22403,"Kamieniec Ząbkowicki, gm.",ząbkowicki,7041,3337,3290,1389,1901
dolnośląskie,22404,"Stoszowice, gm.",ząbkowicki,4607,2101,2070,908,1162
dolnośląskie,22405,"Ząbkowice Śląskie, gm.",ząbkowicki,18623,9512,9400,3820,5580
dolnośląskie,22406,"Ziębice, gm.",ząbkowicki,14778,6668,6607,3031,3576
dolnośląskie,22407,"Złoty Stok, gm.",ząbkowicki,3979,1891,1868,787,1081
dolnośląskie,22501,"Zawidów, m.",zgorzelecki,3499,1776,1754,745,1009
dolnośląskie,22502,"Zgorzelec, m.",zgorzelecki,26754,14678,14502,5374,9128
dolnośląskie,22503,"Bogatynia, gm.",zgorzelecki,19696,9756,9597,4365,5232
dolnośląskie,22504,"Pieńsk, gm.",zgorzelecki,7358,3174,3128,1128,2000
dolnośląskie,22505,"Sulików, gm.",zgorzelecki,4812,2194,2168,1106,1062
dolnośląskie,22506,"Węgliniec, gm.",zgorzelecki,7124,3270,3229,1077,2152
dolnośląskie,22507,"Zgorzelec, gm.",zgorzelecki,6424,2949,2919,1204,1715
dolnośląskie,22601,"Wojcieszów, m.",złotoryjski,3105,1313,1289,428,861
dolnośląskie,22602,"Złotoryja, m.",złotoryjski,13522,6981,6907,2613,4294
dolnośląskie,22603,"Pielgrzymka, gm.",złotoryjski,3688,1731,1721,816,905
dolnośląskie,22604,"Świerzawa, gm.",złotoryjski,6321,2746,2719,1080,1639
dolnośląskie,22605,"Zagrodno, gm.",złotoryjski,4486,2030,2002,1174,828
dolnośląskie,22606,"Złotoryja, gm.",złotoryjski,5584,2599,2573,1237,1336
dolnośląskie,26101,"Jelenia Góra, m.",Jelenia Góra,68974,38642,38137,12499,25638
dolnośląskie,26201,"Legnica, m.",Legnica,80863,43172,42723,17257,25466
dolnośląskie,26401,"Wrocław, m.",Wrocław,499152,306750,303098,107396,195702
kujawsko-pomorskie,40101,"Aleksandrów Kujawski, m.",aleksandrowski,10081,5063,5009,1896,3113
kujawsko-pomorskie,40102,"Ciechocinek, m.",aleksandrowski,11122,7489,7398,2847,4551
kujawsko-pomorskie,40103,"Nieszawa, m.",aleksandrowski,1649,949,920,364,556
kujawsko-pomorskie,40104,"Aleksandrów Kujawski, gm.",aleksandrowski,8586,3765,3723,1903,1820
kujawsko-pomorskie,40105,"Bądkowo, gm.",aleksandrowski,3645,1616,1587,908,679
kujawsko-pomorskie,40106,"Koneck, gm.",aleksandrowski,2697,1206,1197,714,483
kujawsko-pomorskie,40107,"Raciążek, gm.",aleksandrowski,2465,1231,1217,565,652
kujawsko-pomorskie,40108,"Waganiec, gm.",aleksandrowski,3528,1635,1608,982,626
kujawsko-pomorskie,40109,"Zakrzewo, gm.",aleksandrowski,2977,1333,1317,682,635
kujawsko-pomorskie,40201,"Brodnica, m.",brodnicki,21584,11822,11650,4693,6957
kujawsko-pomorskie,40202,"Bobrowo, gm.",brodnicki,5038,2234,2213,1180,1033
kujawsko-pomorskie,40203,"Brodnica, gm.",brodnicki,5498,2519,2493,1195,1298
kujawsko-pomorskie,40204,"Brzozie, gm.",brodnicki,2907,1488,1466,847,619
kujawsko-pomorskie,40205,"Górzno, gm.",brodnicki,3238,1560,1532,897,635
kujawsko-pomorskie,40206,"Bartniczka, gm.",brodnicki,3647,1751,1724,983,741
kujawsko-pomorskie,40207,"Jabłonowo Pomorskie, gm.",brodnicki,7170,3308,3256,1641,1615
kujawsko-pomorskie,40208,"Osiek, gm.",brodnicki,3211,1425,1405,856,549
kujawsko-pomorskie,40209,"Świedziebnia, gm.",brodnicki,4001,1808,1784,1183,601
kujawsko-pomorskie,40210,"Zbiczno, gm.",brodnicki,4068,2179,2159,824,1335
kujawsko-pomorskie,40301,"Białe Błota, gm.",bydgoski,12247,7017,6946,2338,4608
kujawsko-pomorskie,40302,"Dąbrowa Chełmińska, gm.",bydgoski,5816,2662,2634,965,1669
kujawsko-pomorskie,40303,"Dobrcz, gm.",bydgoski,7695,3753,3708,1428,2280
kujawsko-pomorskie,40304,"Koronowo, gm.",bydgoski,19583,9487,9368,3270,6098
kujawsko-pomorskie,40305,"Nowa Wieś Wielka, gm.",bydgoski,6780,3209,3168,1112,2056
kujawsko-pomorskie,40306,"Osielsko, gm.",bydgoski,7936,4938,4881,1463,3418
kujawsko-pomorskie,40307,"Sicienko, gm.",bydgoski,7356,3794,3756,1312,2444
kujawsko-pomorskie,40308,"Solec Kujawski, gm.",bydgoski,12531,6686,6597,2234,4363
kujawsko-pomorskie,40401,"Chełmno, m.",chełmiński,16019,7944,7846,2616,5230
kujawsko-pomorskie,40402,"Chełmno, gm.",chełmiński,4066,1499,1476,610,866
kujawsko-pomorskie,40403,"Kijewo Królewskie, gm.",chełmiński,3416,1533,1501,730,771
kujawsko-pomorskie,40404,"Lisewo, gm.",chełmiński,4031,1585,1570,664,906
kujawsko-pomorskie,40405,"Papowo Biskupie, gm.",chełmiński,3423,1352,1330,566,764
kujawsko-pomorskie,40406,"Stolno, gm.",chełmiński,3960,1542,1521,685,836
kujawsko-pomorskie,40407,"Unisław, gm.",chełmiński,5347,2412,2386,973,1413
kujawsko-pomorskie,40501,"Golub-Dobrzyń, m.",golubsko-dobrzyński,10154,5050,4979,2206,2773
kujawsko-pomorskie,40502,"Ciechocin, gm.",golubsko-dobrzyński,3058,1435,1417,894,523
kujawsko-pomorskie,40503,"Golub-Dobrzyń, gm.",golubsko-dobrzyński,6512,2815,2776,1548,1228
kujawsko-pomorskie,40504,"Kowalewo Pomorskie, gm.",golubsko-dobrzyński,8911,4112,4064,1964,2100
kujawsko-pomorskie,40505,"Radomin, gm.",golubsko-dobrzyński,3255,1553,1537,1044,493
kujawsko-pomorskie,40506,"Zbójno, gm.",golubsko-dobrzyński,3454,1493,1468,887,581
kujawsko-pomorskie,40601,"Grudziądz, gm.",grudziądzki,8711,3942,3887,1567,2320
kujawsko-pomorskie,40602,"Gruta, gm.",grudziądzki,5150,2363,2338,1082,1256
kujawsko-pomorskie,40603,"Łasin, gm.",grudziądzki,6532,2940,2905,1273,1632
kujawsko-pomorskie,40604,"Radzyń Chełmiński, gm.",grudziądzki,3765,1531,1510,752,758
kujawsko-pomorskie,40605,"Rogóźno, gm.",grudziądzki,3187,1336,1326,678,648
kujawsko-pomorskie,40606,"Świecie nad Osą, gm.",grudziądzki,3367,1257,1216,567,649
kujawsko-pomorskie,40701,"Inowrocław, m.",inowrocławski,62179,33631,33179,10437,22742
kujawsko-pomorskie,40702,"Dąbrowa Biskupia, gm.",inowrocławski,4060,1647,1632,816,816
kujawsko-pomorskie,40703,"Gniewkowo, gm.",inowrocławski,11580,5343,5266,2085,3181
kujawsko-pomorskie,40704,"Inowrocław, gm.",inowrocławski,8879,3969,3904,1713,2191
kujawsko-pomorskie,40705,"Janikowo, gm.",inowrocławski,10816,5054,4982,1871,3111
kujawsko-pomorskie,40706,"Kruszwica, gm.",inowrocławski,16209,7202,7122,3185,3937
kujawsko-pomorskie,40707,"Pakość, gm.",inowrocławski,7933,3724,3680,1332,2348
kujawsko-pomorskie,40708,"Rojewo, gm.",inowrocławski,3604,1634,1615,837,778
kujawsko-pomorskie,40709,"Złotniki Kujawskie, gm.",inowrocławski,7244,3364,3307,1466,1841
kujawsko-pomorskie,40801,"Lipno, m.",lipnowski,11862,5765,5685,2531,3154
kujawsko-pomorskie,40802,"Bobrowniki, gm.",lipnowski,2348,1058,1046,505,541
kujawsko-pomorskie,40803,"Chrostkowo, gm.",lipnowski,2407,977,967,610,357
kujawsko-pomorskie,40804,"Dobrzyń nad Wisłą, gm.",lipnowski,6370,2740,2720,1554,1166
kujawsko-pomorskie,40805,"Kikół, gm.",lipnowski,5601,2342,2308,1281,1027
kujawsko-pomorskie,40806,"Lipno, gm.",lipnowski,8902,3637,3572,2013,1559
kujawsko-pomorskie,40807,"Skępe, gm.",lipnowski,6229,2945,2908,1364,1544
kujawsko-pomorskie,40808,"Tłuchowo, gm.",lipnowski,3581,1530,1500,1039,461
kujawsko-pomorskie,40809,"Wielgie, gm.",lipnowski,5144,2034,1990,1078,912
kujawsko-pomorskie,40901,"Dąbrowa, gm.",mogileński,3717,1630,1596,613,983
kujawsko-pomorskie,40902,"Jeziora Wielkie, gm.",mogileński,4116,1677,1641,800,841
kujawsko-pomorskie,40903,"Mogilno, gm.",mogileński,19766,9613,9448,3962,5486
kujawsko-pomorskie,40904,"Strzelno, gm.",mogileński,9755,4604,4547,1858,2689
kujawsko-pomorskie,41001,"Kcynia, gm.",nakielski,10680,5019,4964,1940,3024
kujawsko-pomorskie,41002,"Mrocza, gm.",nakielski,7020,3162,3131,1281,1850
kujawsko-pomorskie,41003,"Nakło nad Notecią, gm.",nakielski,26370,13755,13615,4861,8754
kujawsko-pomorskie,41004,"Sadki, gm.",nakielski,5573,2646,2607,1133,1474
kujawsko-pomorskie,41005,"Szubin, gm.",nakielski,18140,9059,8952,3222,5730
kujawsko-pomorskie,41101,"Radziejów, m.",radziejowski,4946,2484,2447,1047,1400
kujawsko-pomorskie,41102,"Bytoń, gm.",radziejowski,3093,1408,1392,836,556
kujawsko-pomorskie,41103,"Dobre, gm.",radziejowski,4496,2038,2017,1152,865
kujawsko-pomorskie,41104,"Osięciny, gm.",radziejowski,6567,2755,2706,1469,1237
kujawsko-pomorskie,41105,"Piotrków Kujawski, gm.",radziejowski,7852,3582,3508,1977,1531
kujawsko-pomorskie,41106,"Radziejów, gm.",radziejowski,3559,1515,1494,870,624
kujawsko-pomorskie,41107,"Topólka, gm.",radziejowski,4338,2244,2215,1151,1064
kujawsko-pomorskie,41201,"Rypin, m.",rypiński,13350,6967,6897,3106,3791
kujawsko-pomorskie,41202,"Brzuze, gm.",rypiński,4331,1920,1892,1010,882
kujawsko-pomorskie,41203,"Rogowo, gm.",rypiński,3891,1765,1743,1176,567
kujawsko-pomorskie,41204,"Rypin, gm.",rypiński,5781,2328,2310,1378,932
kujawsko-pomorskie,41205,"Skrwilno, gm.",rypiński,4900,2231,2193,1591,602
kujawsko-pomorskie,41206,"Wąpielsk, gm.",rypiński,3313,1356,1339,756,583
kujawsko-pomorskie,41301,"Kamień Krajeński, gm.",sępoleński,5431,2377,2354,847,1507
kujawsko-pomorskie,41302,"Sępólno Krajeńskie, gm.",sępoleński,12638,6176,6107,2184,3923
kujawsko-pomorskie,41303,"Sośno, gm.",sępoleński,4047,1745,1716,712,1004
kujawsko-pomorskie,41304,"Więcbork, gm.",sępoleński,10548,5061,5000,2036,2964
kujawsko-pomorskie,41401,"Bukowiec, gm.",świecki,3996,1709,1687,804,883
kujawsko-pomorskie,41402,"Dragacz, gm.",świecki,5535,2442,2408,874,1534
kujawsko-pomorskie,41403,"Drzycim, gm.",świecki,3879,1698,1676,766,910
kujawsko-pomorskie,41404,"Jeżewo, gm.",świecki,6142,2771,2746,1118,1628
kujawsko-pomorskie,41405,"Lniano, gm.",świecki,3318,1690,1673,753,920
kujawsko-pomorskie,41406,"Nowe, gm.",świecki,8535,3754,3719,1258,2461
kujawsko-pomorskie,41407,"Osie, gm.",świecki,4279,2189,2166,768,1398
kujawsko-pomorskie,41408,"Pruszcz, gm.",świecki,7352,3607,3561,1384,2177
kujawsko-pomorskie,41409,"Świecie, gm.",świecki,26845,13614,13453,4265,9188
kujawsko-pomorskie,41410,"Świekatowo, gm.",świecki,2780,1327,1301,521,780
kujawsko-pomorskie,41411,"Warlubie, gm.",świecki,5181,2098,2080,934,1146
kujawsko-pomorskie,41501,"Chełmża, m.",toruński,11813,5272,5217,2036,3181
kujawsko-pomorskie,41502,"Chełmża, gm.",toruński,7410,2896,2856,1414,1442
kujawsko-pomorskie,41503,"Czernikowo, gm.",toruński,6666,2676,2638,1276,1362
kujawsko-pomorskie,41504,"Lubicz, gm.",toruński,13558,7251,7186,3167,4019
kujawsko-pomorskie,41505,"Łubianka, gm.",toruński,4577,2294,2260,1071,1189
kujawsko-pomorskie,41506,"Łysomice, gm.",toruński,6884,3356,3321,1490,1831
kujawsko-pomorskie,41507,"Obrowo, gm.",toruński,8922,4779,4725,2273,2452
kujawsko-pomorskie,41508,"Wielka Nieszawka, gm.",toruński,3380,1825,1805,636,1169
kujawsko-pomorskie,41509,"Zławieś Wielka, gm.",toruński,9161,4424,4386,1730,2656
kujawsko-pomorskie,41601,"Cekcyn, gm.",tucholski,5321,2679,2652,1131,1521
kujawsko-pomorskie,41602,"Gostycyn, gm.",tucholski,4183,2045,2024,953,1071
kujawsko-pomorskie,41603,"Kęsowo, gm.",tucholski,3495,1582,1551,751,800
kujawsko-pomorskie,41604,"Lubiewo, gm.",tucholski,4606,2465,2442,1135,1307
kujawsko-pomorskie,41605,"Śliwice, gm.",tucholski,4360,2338,2308,1141,1167
kujawsko-pomorskie,41606,"Tuchola, gm.",tucholski,15905,8649,8538,3441,5097
kujawsko-pomorskie,41701,"Wąbrzeźno, m.",wąbrzeski,11088,5480,5411,1636,3775
kujawsko-pomorskie,41702,"Dębowa Łąka, gm.",wąbrzeski,2508,1146,1135,564,571
kujawsko-pomorskie,41703,"Książki, gm.",wąbrzeski,3374,1490,1470,674,796
kujawsko-pomorskie,41704,"Płużnica, gm.",wąbrzeski,3916,1622,1607,673,934
kujawsko-pomorskie,41705,"Wąbrzeźno, gm.",wąbrzeski,6707,2716,2683,1191,1492
kujawsko-pomorskie,41801,"Kowal, m.",włocławski,2822,1467,1454,638,816
kujawsko-pomorskie,41802,"Baruchowo, gm.",włocławski,3061,1474,1451,734,717
kujawsko-pomorskie,41803,"Boniewo, gm.",włocławski,2830,1274,1254,692,562
kujawsko-pomorskie,41804,"Brześć Kujawski, gm.",włocławski,9152,3964,3918,1713,2205
kujawsko-pomorskie,41805,"Choceń, gm.",włocławski,6479,2646,2617,1317,1300
kujawsko-pomorskie,41806,"Chodecz, gm.",włocławski,5457,2444,2416,1280,1136
kujawsko-pomorskie,41807,"Fabianki, gm.",włocławski,7118,3091,3042,1165,1877
kujawsko-pomorskie,41808,"Izbica Kujawska, gm.",włocławski,6279,2839,2807,1948,859
kujawsko-pomorskie,41809,"Kowal, gm.",włocławski,3245,1458,1439,833,606
kujawsko-pomorskie,41810,"Lubanie, gm.",włocławski,3731,1747,1717,998,719
kujawsko-pomorskie,41811,"Lubień Kujawski, gm.",włocławski,6131,2565,2534,1547,987
kujawsko-pomorskie,41812,"Lubraniec, gm.",włocławski,8093,3829,3766,2123,1643
kujawsko-pomorskie,41813,"Włocławek, gm.",włocławski,5471,2541,2512,1033,1479
kujawsko-pomorskie,41901,"Barcin, gm.",żniński,11659,5433,5379,1744,3635
kujawsko-pomorskie,41902,"Gąsawa, gm.",żniński,4382,2275,2238,944,1294
kujawsko-pomorskie,41903,"Janowiec Wielkopolski, gm.",żniński,7499,3343,3284,1321,1963
kujawsko-pomorskie,41904,"Łabiszyn, gm.",żniński,7355,3416,3382,1451,1931
kujawsko-pomorskie,41905,"Rogowo, gm.",żniński,5506,2803,2767,1199,1568
kujawsko-pomorskie,41906,"Żnin, gm.",żniński,19470,9931,9758,4262,5496
kujawsko-pomorskie,46101,"Bydgoszcz, m.",Bydgoszcz,285000,164932,162973,56672,106301
kujawsko-pomorskie,46201,"Grudziądz, m.",Grudziądz,78460,40445,39973,12580,27393
kujawsko-pomorskie,46301,"Toruń, m.",Toruń,158812,93430,92465,33860,58605
kujawsko-pomorskie,46401,"Włocławek, m.",Włocławek,92899,50835,50170,17031,33139
lubelskie,60101,"Międzyrzec Podlaski, m.",bialski,13803,8158,8072,5017,3055
lubelskie,60102,"Terespol, m.",bialski,4641,2683,2655,1254,1401
lubelskie,60103,"Biała Podlaska, gm.",bialski,9838,5510,5444,3420,2024
lubelskie,60104,"Drelów, gm.",bialski,4374,2136,2102,1454,648
lubelskie,60105,"Janów Podlaski, gm.",bialski,4397,2207,2180,1302,878
lubelskie,60106,"Kodeń, gm.",bialski,3342,1751,1733,846,887
lubelskie,60107,"Konstantynów, gm.",bialski,3253,1746,1725,1111,614
lubelskie,60108,"Leśna Podlaska, gm.",bialski,3483,1840,1819,1281,538
lubelskie,60109,"Łomazy, gm.",bialski,4227,2293,2260,1550,710
lubelskie,60110,"Międzyrzec Podlaski, gm.",bialski,7985,4349,4309,3445,864
lubelskie,60111,"Piszczac, gm.",bialski,5853,2817,2796,1829,967
lubelskie,60112,"Rokitno, gm.",bialski,2571,1277,1268,817,451
lubelskie,60113,"Rossosz, gm.",bialski,1948,1135,1119,822,297
lubelskie,60114,"Sławatycze, gm.",bialski,2143,1178,1167,520,647
lubelskie,60115,"Sosnówka, gm.",bialski,2320,1072,1061,616,445
lubelskie,60116,"Terespol, gm.",bialski,5563,3025,2984,1785,1199
lubelskie,60117,"Tuczna, gm.",bialski,2831,1293,1284,827,457
lubelskie,60118,"Wisznice, gm.",bialski,4272,2264,2236,1446,790
lubelskie,60119,"Zalesie, gm.",bialski,3535,1803,1778,1065,713
lubelskie,60201,"Biłgoraj, m.",biłgorajski,21927,12584,12457,6981,5476
lubelskie,60202,"Aleksandrów, gm.",biłgorajski,2463,1389,1375,1106,269
lubelskie,60203,"Biłgoraj, gm.",biłgorajski,10063,5406,5360,4056,1304
lubelskie,60204,"Biszcza, gm.",biłgorajski,3202,1637,1624,1300,324
lubelskie,60205,"Frampol, gm.",biłgorajski,5252,2600,2578,1897,681
lubelskie,60206,"Goraj, gm.",biłgorajski,3596,1914,1898,1499,399
lubelskie,60207,"Józefów, gm.",biłgorajski,5925,2988,2963,1735,1228
lubelskie,60208,"Księżpol, gm.",biłgorajski,5300,2685,2663,2032,631
lubelskie,60209,"Łukowa, gm.",biłgorajski,3520,1966,1953,1576,377
lubelskie,60210,"Obsza, gm.",biłgorajski,3456,1890,1875,1509,366
lubelskie,60211,"Potok Górny, gm.",biłgorajski,4486,2489,2478,2134,344
lubelskie,60212,"Tarnogród, gm.",biłgorajski,5542,2989,2944,2102,842
lubelskie,60213,"Tereszpol, gm.",biłgorajski,3183,1531,1509,1092,417
lubelskie,60214,"Turobin, gm.",biłgorajski,5728,3308,3291,2781,510
lubelskie,60301,"Rejowiec Fabryczny, m.",chełmski,3654,1610,1588,837,751
lubelskie,60302,"Białopole, gm.",chełmski,2652,1122,1107,658,449
lubelskie,60303,"Chełm, gm.",chełmski,10510,5087,5022,3147,1875
lubelskie,60304,"Dorohusk, gm.",chełmski,5593,2561,2542,1555,987
lubelskie,60305,"Dubienka, gm.",chełmski,2187,972,968,497,471
lubelskie,60306,"Kamień, gm.",chełmski,3182,1444,1417,945,472
lubelskie,60307,"Leśniowice, gm.",chełmski,3192,1203,1188,723,465
lubelskie,60308,"Rejowiec Fabryczny, gm.",chełmski,3621,1541,1505,1015,490
lubelskie,60309,"Ruda-Huta, gm.",chełmski,3788,1551,1541,807,734
lubelskie,60310,"Sawin, gm.",chełmski,4608,1993,1970,1185,785
lubelskie,60311,"Siedliszcze, gm.",chełmski,5719,2323,2297,1399,898
lubelskie,60312,"Wierzbica, gm.",chełmski,4314,2042,2022,1456,566
lubelskie,60313,"Wojsławice, gm.",chełmski,3354,1514,1505,1070,435
lubelskie,60314,"Żmudź, gm.",chełmski,2638,1153,1138,722,416
lubelskie,60315,"Rejowiec, gm.",chełmski,5446,2168,2142,1293,849
lubelskie,60401,"Hrubieszów, m.",hrubieszowski,15695,8263,8141,4209,3932
lubelskie,60402,"Dołhobyczów, gm.",hrubieszowski,5089,2242,2222,1562,660
lubelskie,60403,"Horodło, gm.",hrubieszowski,4685,1989,1945,1222,723
lubelskie,60404,"Hrubieszów, gm.",hrubieszowski,8592,3851,3810,2635,1175
lubelskie,60405,"Mircze, gm.",hrubieszowski,6608,2915,2892,1998,894
lubelskie,60406,"Trzeszczany, gm.",hrubieszowski,3856,1779,1763,1247,516
lubelskie,60407,"Uchanie, gm.",hrubieszowski,4188,2067,2058,1587,471
lubelskie,60408,"Werbkowice, gm.",hrubieszowski,8296,3908,3887,2801,1086
lubelskie,60501,"Batorz, gm.",janowski,2791,1724,1703,1460,243
lubelskie,60502,"Chrzanów, gm.",janowski,2546,1769,1753,1645,108
lubelskie,60503,"Dzwola, gm.",janowski,5363,3381,3354,3004,350
lubelskie,60504,"Godziszów, gm.",janowski,4873,3832,3812,3557,255
lubelskie,60505,"Janów Lubelski, gm.",janowski,13342,8073,8000,5885,2115
lubelskie,60506,"Modliborzyce, gm.",janowski,5915,3325,3294,2667,627
lubelskie,60507,"Potok Wielki, gm.",janowski,3912,2052,2034,1636,398
lubelskie,60601,"Krasnystaw, m.",krasnostawski,16691,8526,8434,4062,4372
lubelskie,60602,"Fajsławice, gm.",krasnostawski,4022,2237,2217,1742,475
lubelskie,60603,"Gorzków, gm.",krasnostawski,3289,1540,1521,1060,461
lubelskie,60604,"Izbica, gm.",krasnostawski,7214,3383,3339,2267,1072
lubelskie,60605,"Krasnystaw, gm.",krasnostawski,7343,3488,3459,2212,1247
lubelskie,60606,"Kraśniczyn, gm.",krasnostawski,3518,1583,1564,1020,544
lubelskie,60607,"Łopiennik Górny, gm.",krasnostawski,3479,1595,1588,1210,378
lubelskie,60609,"Rudnik, gm.",krasnostawski,2872,1220,1209,944,265
lubelskie,60610,"Siennica Różana, gm.",krasnostawski,3479,1532,1501,856,645
lubelskie,60611,"Żółkiewka, gm.",krasnostawski,5006,2444,2415,1877,538
lubelskie,60701,"Kraśnik, m.",kraśnicki,29734,16966,16714,10015,6699
lubelskie,60702,"Annopol, gm.",kraśnicki,7406,3849,3824,2843,981
lubelskie,60703,"Dzierzkowice, gm.",kraśnicki,4359,2417,2388,1885,503
lubelskie,60704,"Gościeradów, gm.",kraśnicki,5874,2956,2924,2290,634
lubelskie,60705,"Kraśnik, gm.",kraśnicki,5705,3164,3130,2431,699
lubelskie,60706,"Szastarka, gm.",kraśnicki,4893,2901,2878,2411,467
lubelskie,60707,"Trzydnik Duży, gm.",kraśnicki,5534,2823,2787,2058,729
lubelskie,60708,"Urzędów, gm.",kraśnicki,7042,3906,3867,3083,784
lubelskie,60709,"Wilkołaz, gm.",kraśnicki,4395,2584,2555,2194,361
lubelskie,60710,"Zakrzówek, gm.",kraśnicki,5661,3052,3029,2423,606
lubelskie,60801,"Lubartów, m.",lubartowski,18476,11029,10893,5542,5351
lubelskie,60802,"Abramów, gm.",lubartowski,3482,2066,2025,1698,327
lubelskie,60803,"Firlej, gm.",lubartowski,4903,2340,2312,1488,824
lubelskie,60804,"Jeziorzany, gm.",lubartowski,2484,1233,1214,922,292
lubelskie,60805,"Kamionka, gm.",lubartowski,5126,2654,2619,1749,870
lubelskie,60806,"Kock, gm.",lubartowski,5452,2954,2916,2117,799
lubelskie,60807,"Lubartów, gm.",lubartowski,8191,4363,4318,2810,1508
lubelskie,60808,"Michów, gm.",lubartowski,5158,2534,2509,1885,624
lubelskie,60809,"Niedźwiada, gm.",lubartowski,5045,2625,2612,2010,602
lubelskie,60810,"Ostrów Lubelski, gm.",lubartowski,4413,2348,2323,1720,603
lubelskie,60811,"Ostrówek, gm.",lubartowski,3303,1636,1614,1128,486
lubelskie,60812,"Serniki, gm.",lubartowski,3822,2191,2162,1686,476
lubelskie,60813,"Uścimów, gm.",lubartowski,2874,1543,1522,1010,512
lubelskie,60901,"Bełżyce, gm.",lubelski,10863,5998,5904,4194,1710
lubelskie,60902,"Borzechów, gm.",lubelski,3112,1813,1795,1523,272
lubelskie,60903,"Bychawa, gm.",lubelski,9750,5127,5085,3813,1272
lubelskie,60904,"Garbów, gm.",lubelski,7018,3800,3780,2764,1016
lubelskie,60905,"Głusk, gm.",lubelski,6319,3689,3663,2453,1210
lubelskie,60906,"Jabłonna, gm.",lubelski,6079,2881,2849,2055,794
lubelskie,60907,"Jastków, gm.",lubelski,9685,5771,5719,4010,1709
lubelskie,60908,"Konopnica, gm.",lubelski,9459,5659,5589,3337,2252
lubelskie,60909,"Krzczonów, gm.",lubelski,4037,1999,1972,1458,514
lubelskie,60910,"Niedrzwica Duża, gm.",lubelski,8643,5036,4965,3539,1426
lubelskie,60911,"Niemce, gm.",lubelski,13169,7184,7091,4710,2381
lubelskie,60912,"Strzyżewice, gm.",lubelski,5963,3043,3012,2172,840
lubelskie,60913,"Wojciechów, gm.",lubelski,4764,2411,2351,1752,599
lubelskie,60914,"Wólka, gm.",lubelski,7378,4285,4223,2833,1390
lubelskie,60915,"Wysokie, gm.",lubelski,4022,2129,2105,1687,418
lubelskie,60916,"Zakrzew, gm.",lubelski,2642,1371,1365,1121,244
lubelskie,61001,"Cyców, gm.",łęczyński,6047,2874,2844,1950,894
lubelskie,61002,"Ludwin, gm.",łęczyński,4193,1993,1972,1296,676
lubelskie,61003,"Łęczna, gm.",łęczyński,19561,10548,10430,6654,3776
lubelskie,61004,"Milejów, gm.",łęczyński,7321,3277,3244,2176,1068
lubelskie,61005,"Puchaczów, gm.",łęczyński,4108,2188,2170,1676,494
lubelskie,61006,"Spiczyn, gm.",łęczyński,4169,1958,1938,1294,644
lubelskie,61101,"Łuków, m.",łukowski,24355,14682,14535,8713,5822
lubelskie,61102,"Stoczek Łukowski, m.",łukowski,2183,1360,1346,780,566
lubelskie,61103,"Adamów, gm.",łukowski,4687,2515,2481,1677,804
lubelskie,61104,"Krzywda, gm.",łukowski,8133,4253,4204,3170,1034
lubelskie,61105,"Łuków, gm.",łukowski,12862,7383,7319,5780,1539
lubelskie,61106,"Serokomla, gm.",łukowski,3472,1730,1716,1382,334
lubelskie,61107,"Stanin, gm.",łukowski,7603,4219,4170,3181,989
lubelskie,61108,"Stoczek Łukowski, gm.",łukowski,6794,3784,3760,3084,676
lubelskie,61109,"Trzebieszów, gm.",łukowski,5846,3745,3712,3212,500
lubelskie,61110,"Wojcieszków, gm.",łukowski,5565,3036,3004,2334,670
lubelskie,61111,"Wola Mysłowska, gm.",łukowski,4150,2218,2199,1812,387
lubelskie,61201,"Chodel, gm.",opolski,5350,2894,2872,2370,502
lubelskie,61202,"Józefów nad Wisłą, gm.",opolski,5793,2685,2649,1935,714
lubelskie,61203,"Karczmiska, gm.",opolski,4833,2168,2147,1558,589
lubelskie,61204,"Łaziska, gm.",opolski,4261,2138,2117,1734,383
lubelskie,61205,"Opole Lubelskie, gm.",opolski,15170,7815,7697,4988,2709
lubelskie,61206,"Poniatowa, gm.",opolski,12424,6676,6581,4229,2352
lubelskie,61207,"Wilków, gm.",opolski,3853,1978,1949,1691,258
lubelskie,61301,"Dębowa Kłoda, gm.",parczewski,3368,1656,1644,1006,638
lubelskie,61302,"Jabłoń, gm.",parczewski,3284,1998,1971,1392,579
lubelskie,61303,"Milanów, gm.",parczewski,3336,1817,1786,1272,514
lubelskie,61304,"Parczew, gm.",parczewski,12337,6525,6443,3591,2852
lubelskie,61305,"Podedwórze, gm.",parczewski,1538,813,804,498,306
lubelskie,61306,"Siemień, gm.",parczewski,3974,1999,1978,1395,583
lubelskie,61307,"Sosnowica, gm.",parczewski,2415,1191,1178,653,525
lubelskie,61401,"Puławy, m.",puławski,40495,24588,24274,12381,11893
lubelskie,61402,"Baranów, gm.",puławski,3409,1739,1709,1235,474
lubelskie,61403,"Janowiec, gm.",puławski,3012,1614,1597,1061,536
lubelskie,61404,"Kazimierz Dolny, gm.",puławski,6285,3649,3606,2112,1494
lubelskie,61405,"Końskowola, gm.",puławski,7289,4019,3977,2621,1356
lubelskie,61406,"Kurów, gm.",puławski,6367,3450,3415,2502,913
lubelskie,61407,"Markuszów, gm.",puławski,2437,1328,1309,951,358
lubelskie,61408,"Nałęczów, gm.",puławski,8629,5291,5242,3139,2103
lubelskie,61409,"Puławy, gm.",puławski,9212,5014,4967,3318,1649
lubelskie,61410,"Wąwolnica, gm.",puławski,3867,2156,2141,1610,531
lubelskie,61411,"Żyrzyn, gm.",puławski,5342,3029,2993,2222,771
lubelskie,61501,"Radzyń Podlaski, m.",radzyński,13240,7638,7545,4451,3094
lubelskie,61502,"Borki, gm.",radzyński,4833,2399,2372,1678,694
lubelskie,61503,"Czemierniki, gm.",radzyński,3718,2158,2141,1586,555
lubelskie,61504,"Kąkolewnica Wschodnia, gm.",radzyński,6660,3851,3811,3006,805
lubelskie,61505,"Komarówka Podlaska, gm.",radzyński,3909,2092,2073,1364,709
lubelskie,61506,"Radzyń Podlaski, gm.",radzyński,6336,3507,3466,2642,824
lubelskie,61507,"Ulan-Majorat, gm.",radzyński,4771,2888,2860,2281,579
lubelskie,61508,"Wohyń, gm.",radzyński,5908,3010,2971,2085,886
lubelskie,61601,"Dęblin, m.",rycki,14178,8286,8177,4524,3653
lubelskie,61602,"Kłoczew, gm.",rycki,5977,3482,3421,2838,583
lubelskie,61603,"Nowodwór, gm.",rycki,3413,1957,1935,1504,431
lubelskie,61604,"Ryki, gm.",rycki,17081,9731,9618,6058,3560
lubelskie,61605,"Stężyca, gm.",rycki,4543,2493,2456,1683,773
lubelskie,61606,"Ułęż, gm.",rycki,2963,1631,1600,1010,590
lubelskie,61701,"Świdnik, m.",świdnicki,32872,19131,18898,10245,8653
lubelskie,61702,"Mełgiew, gm.",świdnicki,6768,3692,3648,2571,1077
lubelskie,61703,"Piaski, gm.",świdnicki,8625,4327,4280,3171,1109
lubelskie,61704,"Rybczewice, gm.",świdnicki,3154,1540,1525,1250,275
lubelskie,61705,"Trawniki, gm.",świdnicki,7347,3358,3327,2284,1043
lubelskie,61801,"Tomaszów Lubelski, m.",tomaszowski,17179,9601,9532,5241,4291
lubelskie,61802,"Bełżec, gm.",tomaszowski,2777,1340,1325,798,527
lubelskie,61803,"Jarczów, gm.",tomaszowski,3021,1515,1491,1127,364
lubelskie,61804,"Krynice, gm.",tomaszowski,2958,1586,1566,1159,407
lubelskie,61805,"Lubycza Królewska, gm.",tomaszowski,5427,2136,2105,1136,969
lubelskie,61806,"Łaszczów, gm.",tomaszowski,5402,2550,2512,1759,753
lubelskie,61807,"Rachanie, gm.",tomaszowski,4760,2332,2301,1795,506
lubelskie,61808,"Susiec, gm.",tomaszowski,6608,3421,3377,2371,1006
lubelskie,61809,"Tarnawatka, gm.",tomaszowski,3239,1654,1638,1203,435
lubelskie,61810,"Telatyn, gm.",tomaszowski,3655,1807,1794,1375,419
lubelskie,61811,"Tomaszów Lubelski, gm.",tomaszowski,8798,4524,4489,3224,1265
lubelskie,61812,"Tyszowce, gm.",tomaszowski,4997,2265,2255,1706,549
lubelskie,61813,"Ulhówek, gm.",tomaszowski,4312,1707,1694,1188,506
lubelskie,61901,"Włodawa, m.",włodawski,11852,6264,6182,2711,3471
lubelskie,61902,"Hanna, gm.",włodawski,2668,1293,1279,763,516
lubelskie,61903,"Hańsk, gm.",włodawski,3116,1368,1350,740,610
lubelskie,61904,"Stary Brus, gm.",włodawski,1828,892,885,557,328
lubelskie,61905,"Urszulin, gm.",włodawski,3512,1941,1918,1231,687
lubelskie,61906,"Włodawa, gm.",włodawski,5531,2949,2905,1448,1457
lubelskie,61907,"Wola Uhruska, gm.",włodawski,3451,1647,1629,996,633
lubelskie,61908,"Wyryki, gm.",włodawski,2313,1041,1029,588,441
lubelskie,62001,"Adamów, gm.",zamojski,4011,2151,2137,1682,455
lubelskie,62002,"Grabowiec, gm.",zamojski,3760,1609,1595,1247,348
lubelskie,62003,"Komarów-Osada, gm.",zamojski,4460,2484,2465,1803,662
lubelskie,62004,"Krasnobród, gm.",zamojski,6024,3682,3648,2780,868
lubelskie,62005,"Łabunie, gm.",zamojski,4949,2841,2822,2255,567
lubelskie,62006,"Miączyn, gm.",zamojski,4965,2316,2302,1675,627
lubelskie,62007,"Nielisz, gm.",zamojski,4815,2204,2188,1700,488
lubelskie,62008,"Radecznica, gm.",zamojski,5481,2562,2548,2005,543
lubelskie,62009,"Sitno, gm.",zamojski,5538,2962,2927,2290,637
lubelskie,62010,"Skierbieszów, gm.",zamojski,4537,2312,2290,1739,551
lubelskie,62011,"Stary Zamość, gm.",zamojski,4400,2379,2360,1721,639
lubelskie,62012,"Sułów, gm.",zamojski,4062,1851,1837,1409,428
lubelskie,62013,"Szczebrzeszyn, gm.",zamojski,9764,4632,4586,3239,1347
lubelskie,62014,"Zamość, gm.",zamojski,16903,9033,8931,6071,2860
lubelskie,62015,"Zwierzyniec, gm.",zamojski,6026,2973,2948,1621,1327
lubelskie,66101,"Biała Podlaska, m.",Biała Podlaska,45186,26756,26446,13604,12842
lubelskie,66201,"Chełm, m.",Chełm,54972,29379,29003,13880,15123
lubelskie,66301,"Lublin, m.",Lublin,276097,167556,165683,83261,82422
lubelskie,66401,"Zamość, m.",Zamość,54237,29706,29397,15567,13830
lubuskie,80101,"Kostrzyn nad Odrą, m.",gorzowski,13830,6858,6793,2141,4652
lubuskie,80102,"Bogdaniec, gm.",gorzowski,5225,2369,2340,929,1411
lubuskie,80103,"Deszczno, gm.",gorzowski,6334,2878,2844,1167,1677
lubuskie,80104,"Kłodawa, gm.",gorzowski,5560,3047,3006,859,2147
lubuskie,80105,"Lubiszyn, gm.",gorzowski,5310,2264,2235,731,1504
lubuskie,80106,"Santok, gm.",gorzowski,6026,2677,2640,834,1806
lubuskie,80107,"Witnica, gm.",gorzowski,10010,4271,4184,1658,2526
lubuskie,80201,"Gubin, m.",krośnieński,13497,6491,6386,1681,4705
lubuskie,80202,"Bobrowice, gm.",krośnieński,2602,1230,1226,433,793
lubuskie,80203,"Bytnica, gm.",krośnieński,2117,772,761,287,474
lubuskie,80204,"Dąbie, gm.",krośnieński,3938,1694,1668,600,1068
lubuskie,80205,"Gubin, gm.",krośnieński,5782,2365,2342,824,1518
lubuskie,80206,"Krosno Odrzańskie, gm.",krośnieński,14927,7416,7320,2386,4934
lubuskie,80207,"Maszewo, gm.",krośnieński,2300,806,797,294,503
lubuskie,80301,"Bledzew, gm.",międzyrzecki,3845,1649,1632,478,1154
lubuskie,80302,"Międzyrzecz, gm.",międzyrzecki,21136,10584,10486,3289,7197
lubuskie,80303,"Przytoczna, gm.",międzyrzecki,4664,2190,2155,596,1559
lubuskie,80304,"Pszczew, gm.",międzyrzecki,3780,1963,1948,626,1322
lubuskie,80305,"Skwierzyna, gm.",międzyrzecki,10140,4937,4889,1590,3299
lubuskie,80306,"Trzciel, gm.",międzyrzecki,5204,2308,2276,770,1506
lubuskie,80401,"Nowa Sól, m.",nowosolski,32496,16602,16427,5941,10486
lubuskie,80402,"Bytom Odrzański, gm.",nowosolski,4229,1864,1848,696,1152
lubuskie,80403,"Kolsko, gm.",nowosolski,2700,1200,1187,452,735
lubuskie,80404,"Kożuchów, gm.",nowosolski,12681,5607,5554,2115,3439
lubuskie,80405,"Nowa Sól, gm.",nowosolski,5273,2343,2334,1073,1261
lubuskie,80406,"Nowe Miasteczko, gm.",nowosolski,4367,1938,1886,861,1025
lubuskie,80407,"Otyń, gm.",nowosolski,4941,2284,2258,889,1369
lubuskie,80408,"Siedlisko, gm.",nowosolski,2714,1170,1160,522,638
lubuskie,80501,"Cybinka, gm.",słubicki,5336,2248,2218,874,1344
lubuskie,80502,"Górzyca, gm.",słubicki,3251,1384,1368,561,807
lubuskie,80503,"Ośno Lubuskie, gm.",słubicki,5049,2277,2247,661,1586
lubuskie,80504,"Rzepin, gm.",słubicki,7741,3567,3519,1166,2353
lubuskie,80505,"Słubice, gm.",słubicki,15364,7854,7782,2231,5551
lubuskie,80601,"Dobiegniew, gm.",strzelecko-drezdenecki,5854,2583,2559,856,1703
lubuskie,80602,"Drezdenko, gm.",strzelecko-drezdenecki,14152,6737,6666,2423,4243
lubuskie,80603,"Stare Kurowo, gm.",strzelecko-drezdenecki,3336,1399,1381,464,917
lubuskie,80604,"Strzelce Krajeńskie, gm.",strzelecko-drezdenecki,13917,6016,5954,1662,4292
lubuskie,80605,"Zwierzyn, gm.",strzelecko-drezdenecki,3398,1449,1433,526,907
lubuskie,80701,"Krzeszyce, gm.",sulęciński,3680,1693,1674,634,1040
lubuskie,80702,"Lubniewice, gm.",sulęciński,2638,1258,1242,393,849
lubuskie,80703,"Słońsk, gm.",sulęciński,4195,1899,1878,726,1152
lubuskie,80704,"Sulęcin, gm.",sulęciński,12724,6100,6036,2395,3641
lubuskie,80705,"Torzym, gm.",sulęciński,5626,2340,2295,681,1614
lubuskie,80801,"Lubrza, gm.",świebodziński,2860,1326,1311,403,908
lubuskie,80802,"Łagów, gm.",świebodziński,4548,2109,2092,652,1440
lubuskie,80803,"Skąpe, gm.",świebodziński,4462,2059,2036,618,1418
lubuskie,80804,"Szczaniec, gm.",świebodziński,3065,1393,1377,577,800
lubuskie,80805,"Świebodzin, gm.",świebodziński,23621,11914,11775,3990,7785
lubuskie,80806,"Zbąszynek, gm.",świebodziński,6570,3355,3314,894,2420
lubuskie,80901,"Babimost, gm.",zielonogórski,4967,2611,2578,702,1876
lubuskie,80902,"Bojadła, gm.",zielonogórski,2683,1168,1158,348,810
lubuskie,80903,"Czerwieńsk, gm.",zielonogórski,7451,3641,3594,1114,2480
lubuskie,80904,"Kargowa, gm.",zielonogórski,4624,2065,2045,608,1437
lubuskie,80905,"Nowogród Bobrzański, gm.",zielonogórski,8372,3924,3878,1083,2795
lubuskie,80906,"Sulechów, gm.",zielonogórski,20889,10315,10198,3116,7082
lubuskie,80907,"Świdnica, gm.",zielonogórski,4705,2464,2430,644,1786
lubuskie,80908,"Trzebiechów, gm.",zielonogórski,2556,1016,1000,296,704
lubuskie,80909,"Zabór, gm.",zielonogórski,2832,1434,1422,409,1013
lubuskie,80910,"Zielona Góra, gm.",zielonogórski,13510,7369,7306,2300,5006
lubuskie,81001,"Gozdnica, m.",żagański,2733,1118,1107,380,727
lubuskie,81002,"Żagań, m.",żagański,21018,10781,10656,3552,7104
lubuskie,81003,"Brzeźnica, gm.",żagański,2969,1378,1366,650,716
lubuskie,81004,"Iłowa, gm.",żagański,5742,2557,2522,825,1697
lubuskie,81005,"Małomice, gm.",żagański,4422,1833,1802,659,1143
lubuskie,81006,"Niegosławice, gm.",żagański,3650,1517,1502,858,644
lubuskie,81007,"Szprotawa, gm.",żagański,17275,7525,7449,2762,4687
lubuskie,81008,"Wymiarki, gm.",żagański,1994,825,808,326,482
lubuskie,81009,"Żagań, gm.",żagański,5444,2197,2173,812,1361
lubuskie,81101,"Łęknica, m.",żarski,1986,783,782,215,567
lubuskie,81102,"Żary, m.",żarski,31034,16085,15883,5076,10807
lubuskie,81103,"Brody, gm.",żarski,2766,1154,1141,367,774
lubuskie,81104,"Jasień, gm.",żarski,5721,2373,2348,843,1505
lubuskie,81105,"Lipinki Łużyckie, gm.",żarski,2559,1026,1016,364,652
lubuskie,81106,"Lubsko, gm.",żarski,15467,6773,6685,2073,4612
lubuskie,81107,"Przewóz, gm.",żarski,2535,1065,1054,407,647
lubuskie,81108,"Trzebiel, gm.",żarski,4643,1888,1861,668,1193
lubuskie,81109,"Tuplice, gm.",żarski,2630,1083,1066,315,751
lubuskie,81110,"Żary, gm.",żarski,9221,4005,3968,1523,2445
lubuskie,81201,"Sława, gm.",wschowski,10345,5304,5242,1797,3445
lubuskie,81202,"Szlichtyngowa, gm.",wschowski,3925,1778,1761,943,818
lubuskie,81203,"Wschowa, gm.",wschowski,17181,8696,8572,3664,4908
lubuskie,86101,"Gorzów Wielkopolski, m.",Gorzów Wielkopolski,98552,52992,52362,17759,34603
lubuskie,86201,"Zielona Góra, m.",Zielona Góra,91598,54575,53911,15415,38496
łódzkie,100101,"Bełchatów, m.",bełchatowski,49408,29528,29091,19097,9994
łódzkie,100102,"Bełchatów, gm.",bełchatowski,7907,4792,4729,3721,1008
łódzkie,100103,"Drużbice, gm.",bełchatowski,4066,2220,2189,1603,586
łódzkie,100104,"Kleszczów, gm.",bełchatowski,3524,2144,2115,1607,508
łódzkie,100105,"Kluki, gm.",bełchatowski,3272,1760,1738,1342,396
łódzkie,100106,"Rusiec, gm.",bełchatowski,4275,2493,2442,1737,705
łódzkie,100107,"Szczerców, gm.",bełchatowski,6319,3624,3576,2625,951
łódzkie,100108,"Zelów, gm.",bełchatowski,12185,6583,6487,4535,1952
łódzkie,100201,"Kutno, m.",kutnowski,38473,21118,20871,10443,10428
łódzkie,100202,"Bedlno, gm.",kutnowski,4962,2248,2207,1552,655
łódzkie,100203,"Dąbrowice, gm.",kutnowski,1678,786,776,598,178
łódzkie,100204,"Krośniewice, gm.",kutnowski,7310,3322,3284,2010,1274
łódzkie,100205,"Krzyżanów, gm.",kutnowski,3589,1709,1681,1205,476
łódzkie,100206,"Kutno, gm.",kutnowski,6795,3367,3339,2241,1098
łódzkie,100207,"Łanięta, gm.",kutnowski,1989,830,815,585,230
łódzkie,100208,"Nowe Ostrowy, gm.",kutnowski,3085,1341,1320,797,523
łódzkie,100209,"Oporów, gm.",kutnowski,2236,1114,1095,865,230
łódzkie,100210,"Strzelce, gm.",kutnowski,3356,1655,1634,1185,449
łódzkie,100211,"Żychlin, gm.",kutnowski,10672,4829,4770,2682,2088
łódzkie,100301,"Buczek, gm.",łaski,3986,2002,1983,1303,680
łódzkie,100302,"Łask, gm.",łaski,23108,12381,12176,6375,5801
łódzkie,100303,"Sędziejowice, gm.",łaski,5223,2705,2679,1796,883
łódzkie,100304,"Widawa, gm.",łaski,6510,3304,3268,2396,872
łódzkie,100305,"Wodzierady, gm.",łaski,2632,1453,1436,861,575
łódzkie,100401,"Łęczyca, m.",łęczycki,12313,6544,6456,2681,3775
łódzkie,100402,"Daszyna, gm.",łęczycki,3441,1485,1467,1050,417
łódzkie,100403,"Góra Świętej Małgorzaty, gm.",łęczycki,3612,1784,1766,1413,353
łódzkie,100404,"Grabów, gm.",łęczycki,5262,2589,2571,1992,579
łódzkie,100405,"Łęczyca, gm.",łęczycki,7965,3980,3937,2572,1365
łódzkie,100406,"Piątek, gm.",łęczycki,5205,2632,2606,1954,652
łódzkie,100407,"Świnice Warckie, gm.",łęczycki,3289,1595,1576,1101,475
łódzkie,100408,"Witonia, gm.",łęczycki,2847,1389,1374,977,397
łódzkie,100501,"Łowicz, m.",łowicki,24944,14290,14109,6831,7278
łódzkie,100502,"Bielawy, gm.",łowicki,4865,2313,2268,1547,721
łódzkie,100503,"Chąśno, gm.",łowicki,2479,1330,1315,1074,241
łódzkie,100504,"Domaniewice, gm.",łowicki,3739,1824,1810,1369,441
łódzkie,100505,"Kiernozia, gm.",łowicki,2958,1512,1490,1179,311
łódzkie,100506,"Kocierzew Południowy, gm.",łowicki,3589,2087,2060,1688,372
łódzkie,100507,"Łowicz, gm.",łowicki,5905,3208,3163,2231,932
łódzkie,100508,"Łyszkowice, gm.",łowicki,5408,2654,2610,1829,781
łódzkie,100509,"Nieborów, gm.",łowicki,7659,4047,3992,2672,1320
łódzkie,100510,"Zduny, gm.",łowicki,4953,2441,2405,1685,720
łódzkie,100602,"Andrespol, gm.",łódzki wschodni,9877,6033,5963,2855,3108
łódzkie,100603,"Brójce, gm.",łódzki wschodni,4571,2642,2619,1737,882
łódzkie,100607,"Koluszki, gm.",łódzki wschodni,18728,10969,10815,5897,4918
łódzkie,100608,"Nowosolna, gm.",łódzki wschodni,3176,1950,1927,880,1047
łódzkie,100610,"Rzgów, gm.",łódzki wschodni,7332,4452,4398,2596,1802
łódzkie,100611,"Tuszyn, gm.",łódzki wschodni,9747,5456,5413,3162,2251
łódzkie,100701,"Białaczów, gm.",opoczyński,4843,2569,2522,1862,660
łódzkie,100702,"Drzewica, gm.",opoczyński,8885,5431,5328,3979,1349
łódzkie,100703,"Mniszków, gm.",opoczyński,3805,2236,2218,1674,544
łódzkie,100704,"Opoczno, gm.",opoczyński,28212,17456,17182,11828,5354
łódzkie,100705,"Paradyż, gm.",opoczyński,3598,2158,2135,1806,329
łódzkie,100706,"Poświętne, gm.",opoczyński,2878,1814,1796,1373,423
łódzkie,100707,"Sławno, gm.",opoczyński,5959,3571,3521,2892,629
łódzkie,100708,"Żarnów, gm.",opoczyński,5212,2986,2942,2208,734
łódzkie,100801,"Konstantynów Łódzki, m.",pabianicki,14336,8080,7982,3529,4453
łódzkie,100802,"Pabianice, m.",pabianicki,56523,32300,31888,13354,18534
łódzkie,100803,"Dłutów, gm.",pabianicki,3381,1965,1950,1306,644
łódzkie,100804,"Dobroń, gm.",pabianicki,5580,3168,3142,1610,1532
łódzkie,100805,"Ksawerów, gm.",pabianicki,5847,3410,3364,1538,1826
łódzkie,100806,"Lutomiersk, gm.",pabianicki,5941,3163,3127,1757,1370
łódzkie,100807,"Pabianice, gm.",pabianicki,4808,2883,2845,1650,1195
łódzkie,100901,"Działoszyn, gm.",pajęczański,10457,5387,5304,3245,2059
łódzkie,100902,"Kiełczygłów, gm.",pajęczański,3549,1904,1884,1420,464
łódzkie,100903,"Nowa Brzeźnica, gm.",pajęczański,3994,2018,1990,1364,626
łódzkie,100904,"Pajęczno, gm.",pajęczański,9653,5125,5059,3333,1726
łódzkie,100905,"Rząśnia, gm.",pajęczański,3808,2132,2114,1632,482
łódzkie,100906,"Siemkowice, gm.",pajęczański,3984,1977,1960,1399,561
łódzkie,100907,"Strzelce Wielkie, gm.",pajęczański,3923,2084,2061,1602,459
łódzkie,100908,"Sulmierzyce, gm.",pajęczański,3737,2155,2121,1585,536
łódzkie,101001,"Aleksandrów, gm.",piotrkowski,3879,2207,2188,1628,560
łódzkie,101002,"Czarnocin, gm.",piotrkowski,3205,1825,1806,1346,460
łódzkie,101003,"Gorzkowice, gm.",piotrkowski,6816,3748,3697,2918,779
łódzkie,101004,"Grabica, gm.",piotrkowski,4821,2701,2673,2075,598
łódzkie,101005,"Łęki Szlacheckie, gm.",piotrkowski,3023,1508,1497,1152,345
łódzkie,101006,"Moszczenica, gm.",piotrkowski,10130,5754,5694,4220,1474
łódzkie,101007,"Ręczno, gm.",piotrkowski,3187,1806,1781,1206,575
łódzkie,101008,"Rozprza, gm.",piotrkowski,9419,5048,4979,3759,1220
łódzkie,101009,"Sulejów, gm.",piotrkowski,12807,7584,7485,4981,2504
łódzkie,101010,"Wola Krzysztoporska, gm.",piotrkowski,9044,5315,5265,4268,997
łódzkie,101011,"Wolbórz, gm.",piotrkowski,6289,3881,3812,2484,1328
łódzkie,101101,"Dalików, gm.",poddębicki,3067,1529,1510,996,514
łódzkie,101102,"Pęczniew, gm.",poddębicki,3159,1670,1637,1027,610
łódzkie,101103,"Poddębice, gm.",poddębicki,13009,6624,6521,3547,2974
łódzkie,101104,"Uniejów, gm.",poddębicki,6320,3479,3443,2358,1085
łódzkie,101105,"Wartkowice, gm.",poddębicki,5101,2393,2362,1656,706
łódzkie,101106,"Zadzim, gm.",poddębicki,4439,2315,2287,1460,827
łódzkie,101201,"Radomsko, m.",radomszczański,39351,21322,21060,10873,10187
łódzkie,101202,"Dobryszyce, gm.",radomszczański,3267,1687,1669,1167,502
łódzkie,101203,"Gidle, gm.",radomszczański,5346,2531,2493,1532,961
łódzkie,101204,"Gomunice, gm.",radomszczański,4710,2640,2596,1816,780
łódzkie,101205,"Kamieńsk, gm.",radomszczański,4784,2830,2794,2183,611
łódzkie,101206,"Kobiele Wielkie, gm.",radomszczański,3605,1693,1672,1111,561
łódzkie,101207,"Kodrąb, gm.",radomszczański,3873,1918,1888,1321,567
łódzkie,101208,"Lgota Wielka, gm.",radomszczański,3464,1778,1726,1238,488
łódzkie,101209,"Ładzice, gm.",radomszczański,3870,1868,1836,1203,633
łódzkie,101210,"Masłowice, gm.",radomszczański,3618,1761,1743,1299,444
łódzkie,101211,"Przedbórz, gm.",radomszczański,6246,3315,3262,2179,1083
łódzkie,101212,"Radomsko, gm.",radomszczański,4471,2295,2264,1450,814
łódzkie,101213,"Wielgomłyny, gm.",radomszczański,3976,1927,1906,1443,463
łódzkie,101214,"Żytno, gm.",radomszczański,4786,2175,2147,1468,679
łódzkie,101301,"Rawa Mazowiecka, m.",rawski,14415,8398,8293,4855,3438
łódzkie,101302,"Biała Rawska, gm.",rawski,9436,4832,4782,3470,1312
łódzkie,101303,"Cielądz, gm.",rawski,3319,1679,1670,1333,337
łódzkie,101304,"Rawa Mazowiecka, gm.",rawski,6857,3563,3535,2713,822
łódzkie,101305,"Regnów, gm.",rawski,1476,755,749,614,135
łódzkie,101306,"Sadkowice, gm.",rawski,4684,2375,2350,1883,467
łódzkie,101401,"Sieradz, m.",sieradzki,35909,20968,20640,9880,10760
łódzkie,101402,"Błaszki, gm.",sieradzki,12016,5888,5816,4270,1546
łódzkie,101403,"Brąszewice, gm.",sieradzki,3404,1860,1843,1451,392
łódzkie,101404,"Brzeźnio, gm.",sieradzki,4934,2547,2505,1550,955
łódzkie,101405,"Burzenin, gm.",sieradzki,4626,2304,2276,1498,778
łódzkie,101406,"Goszczanów, gm.",sieradzki,4482,2015,2003,1531,472
łódzkie,101407,"Klonowa, gm.",sieradzki,2408,1226,1203,828,375
łódzkie,101408,"Sieradz, gm.",sieradzki,7841,4237,4188,2925,1263
łódzkie,101409,"Warta, gm.",sieradzki,10528,5372,5312,3846,1466
łódzkie,101410,"Wróblew, gm.",sieradzki,4934,2346,2320,1729,591
łódzkie,101411,"Złoczew, gm.",sieradzki,5854,2990,2958,2111,847
łódzkie,101501,"Bolimów, gm.",skierniewicki,3372,1807,1774,1135,639
łódzkie,101502,"Głuchów, gm.",skierniewicki,4768,3198,3147,2674,473
łódzkie,101503,"Godzianów, gm.",skierniewicki,2093,1237,1216,986,230
łódzkie,101504,"Kowiesy, gm.",skierniewicki,2508,1358,1339,940,399
łódzkie,101505,"Lipce Reymontowskie, gm.",skierniewicki,2676,1419,1395,993,402
łódzkie,101506,"Maków, gm.",skierniewicki,4816,2697,2663,1932,731
łódzkie,101507,"Nowy Kawęczyn, gm.",skierniewicki,2680,1471,1457,1055,402
łódzkie,101508,"Skierniewice, gm.",skierniewicki,5549,2813,2774,1921,853
łódzkie,101509,"Słupia, gm.",skierniewicki,2119,1188,1172,938,234
łódzkie,101601,"Tomaszów Mazowiecki, m.",tomaszowski,52914,30763,30383,15008,15375
łódzkie,101602,"Będków, gm.",tomaszowski,2828,1614,1599,1232,367
łódzkie,101603,"Budziszewice, gm.",tomaszowski,1817,1126,1114,793,321
łódzkie,101604,"Czerniewice, gm.",tomaszowski,4239,2235,2195,1668,527
łódzkie,101605,"Inowłódz, gm.",tomaszowski,3613,2263,2236,1225,1011
łódzkie,101606,"Lubochnia, gm.",tomaszowski,5764,3374,3328,2484,844
łódzkie,101607,"Rokiciny, gm.",tomaszowski,4918,2760,2724,1842,882
łódzkie,101608,"Rzeczyca, gm.",tomaszowski,4020,2308,2273,1788,485
łódzkie,101609,"Tomaszów Mazowiecki, gm.",tomaszowski,8381,4933,4862,3198,1664
łódzkie,101610,"Ujazd, gm.",tomaszowski,6361,3647,3596,2353,1243
łódzkie,101611,"Żelechlinek, gm.",tomaszowski,2796,1563,1548,1207,341
łódzkie,101701,"Biała, gm.",wieluński,4443,2192,2162,1478,684
łódzkie,101702,"Czarnożyły, gm.",wieluński,3630,1933,1914,1285,629
łódzkie,101703,"Konopnica, gm.",wieluński,3344,1790,1760,1006,754
łódzkie,101704,"Mokrsko, gm.",wieluński,4294,2263,2238,1420,818
łódzkie,101705,"Osjaków, gm.",wieluński,3880,2140,2116,1527,589
łódzkie,101706,"Ostrówek, gm.",wieluński,3667,1769,1748,1199,549
łódzkie,101707,"Pątnów, gm.",wieluński,5150,2779,2741,1981,760
łódzkie,101708,"Skomlin, gm.",wieluński,2693,1389,1362,800,562
łódzkie,101709,"Wieluń, gm.",wieluński,27057,14771,14571,7083,7488
łódzkie,101710,"Wierzchlas, gm.",wieluński,5393,2637,2603,1601,1002
łódzkie,101801,"Bolesławiec, gm.",wieruszowski,3369,1644,1619,964,655
łódzkie,101802,"Czastary, gm.",wieruszowski,3179,1540,1519,1002,517
łódzkie,101803,"Galewice, gm.",wieruszowski,4919,2352,2317,1452,865
łódzkie,101804,"Lututów, gm.",wieruszowski,3776,1929,1901,1314,587
łódzkie,101805,"Łubnice, gm.",wieruszowski,3286,1561,1527,939,588
łódzkie,101806,"Sokolniki, gm.",wieruszowski,3893,1958,1938,1277,661
łódzkie,101807,"Wieruszów, gm.",wieruszowski,11475,6276,6195,3265,2930
łódzkie,101901,"Zduńska Wola, m.",zduńskowolski,35244,19682,19448,9589,9859
łódzkie,101902,"Szadek, gm.",zduńskowolski,5923,2974,2934,1917,1017
łódzkie,101903,"Zapolice, gm.",zduńskowolski,3834,1863,1847,1148,699
łódzkie,101904,"Zduńska Wola, gm.",zduńskowolski,8881,4529,4483,2817,1666
łódzkie,102001,"Głowno, m.",zgierski,12399,6519,6452,2831,3621
łódzkie,102002,"Ozorków, m.",zgierski,16633,8696,8613,4336,4277
łódzkie,102003,"Zgierz, m.",zgierski,46828,26744,26411,11707,14704
łódzkie,102004,"Aleksandrów Łódzki, gm.",zgierski,22432,12688,12516,5184,7332
łódzkie,102005,"Głowno, gm.",zgierski,3932,1990,1962,1412,550
łódzkie,102006,"Ozorków, gm.",zgierski,5546,3227,3189,2060,1129
łódzkie,102007,"Parzęczew, gm.",zgierski,4030,2193,2177,1206,971
łódzkie,102008,"Stryków, gm.",zgierski,9881,5410,5360,2778,2582
łódzkie,102009,"Zgierz, gm.",zgierski,9943,6026,5953,3128,2825
łódzkie,102101,"Brzeziny, m.",brzeziński,10084,5476,5407,3052,2355
łódzkie,102102,"Brzeziny, gm.",brzeziński,4280,2323,2307,1543,764
łódzkie,102103,"Dmosin, gm.",brzeziński,3805,1964,1934,1300,634
łódzkie,102104,"Jeżów, gm.",brzeziński,2802,1608,1581,1152,429
łódzkie,102105,"Rogów, gm.",brzeziński,3911,2195,2176,1380,796
łódzkie,106101,"Łódź, m.",Łódź,584653,340231,335822,121265,214557
łódzkie,106201,"Piotrków Trybunalski, m.",Piotrków Trybunalski,62441,36397,35919,18291,17628
łódzkie,106301,"Skierniewice, m.",Skierniewice,38887,23052,22766,10479,12287
małopolskie,120101,"Bochnia, m.",bocheński,23657,14486,14343,7647,6696
małopolskie,120102,"Bochnia, gm.",bocheński,14669,8439,8369,5660,2709
małopolskie,120103,"Drwinia, gm.",bocheński,5053,2951,2927,2325,602
małopolskie,120104,"Lipnica Murowana, gm.",bocheński,4321,2600,2581,1912,669
małopolskie,120105,"Łapanów, gm.",bocheński,5880,3392,3360,2318,1042
małopolskie,120106,"Nowy Wiśnicz, gm.",bocheński,10464,6512,6462,4501,1961
małopolskie,120107,"Rzezawa, gm.",bocheński,8298,4735,4697,3478,1219
małopolskie,120108,"Trzciana, gm.",bocheński,4049,2599,2577,1953,624
małopolskie,120109,"Żegocina, gm.",bocheński,3993,2795,2776,2304,472
małopolskie,120201,"Borzęcin, gm.",brzeski,6559,3551,3522,2505,1017
małopolskie,120202,"Brzesko, gm.",brzeski,28497,16506,16344,9850,6494
małopolskie,120203,"Czchów, gm.",brzeski,7150,4256,4213,2984,1229
małopolskie,120204,"Dębno, gm.",brzeski,10931,6503,6442,4486,1956
małopolskie,120205,"Gnojnik, gm.",brzeski,5755,3257,3230,2497,733
małopolskie,120206,"Iwkowa, gm.",brzeski,4710,2901,2880,2362,518
małopolskie,120207,"Szczurowa, gm.",brzeski,7815,3946,3924,2698,1226
małopolskie,120301,"Alwernia, gm.",chrzanowski,10336,5796,5729,2927,2802
małopolskie,120302,"Babice, gm.",chrzanowski,7103,4052,4001,2165,1836
małopolskie,120303,"Chrzanów, gm.",chrzanowski,39749,22563,22261,8744,13517
małopolskie,120304,"Libiąż, gm.",chrzanowski,18133,10223,10102,5212,4890
małopolskie,120305,"Trzebinia, gm.",chrzanowski,28152,15909,15727,6652,9075
małopolskie,120401,"Bolesław, gm.",dąbrowski,2380,1081,1060,841,219
małopolskie,120402,"Dąbrowa Tarnowska, gm.",dąbrowski,16601,8764,8690,6303,2387
małopolskie,120403,"Gręboszów, gm.",dąbrowski,2967,1586,1573,1300,273
małopolskie,120404,"Mędrzechów, gm.",dąbrowski,2870,1461,1441,1072,369
małopolskie,120405,"Olesno, gm.",dąbrowski,6138,3330,3304,2753,551
małopolskie,120406,"Radgoszcz, gm.",dąbrowski,5598,3122,3089,2686,403
małopolskie,120407,"Szczucin, gm.",dąbrowski,10603,5398,5342,3770,1572
małopolskie,120501,"Gorlice, m.",gorlicki,24235,13570,13425,6897,6528
małopolskie,120502,"Biecz, gm.",gorlicki,13564,7374,7291,5087,2204
małopolskie,120503,"Bobowa, gm.",gorlicki,7022,4051,4026,3077,949
małopolskie,120504,"Gorlice, gm.",gorlicki,13124,7352,7277,4901,2376
małopolskie,120505,"Lipinki, gm.",gorlicki,5444,2909,2880,2063,817
małopolskie,120506,"Łużna, gm.",gorlicki,6439,3440,3408,2352,1056
małopolskie,120507,"Moszczenica, gm.",gorlicki,3740,1902,1879,1469,410
małopolskie,120508,"Ropa, gm.",gorlicki,3909,2441,2412,1829,583
małopolskie,120509,"Sękowa, gm.",gorlicki,3921,2152,2131,1256,875
małopolskie,120510,"Uście Gorlickie, gm.",gorlicki,5623,3253,3221,1528,1693
małopolskie,120601,"Czernichów, gm.",krakowski,10533,5737,5660,3539,2121
małopolskie,120602,"Igołomia-Wawrzeńczyce, gm.",krakowski,6086,2639,2617,1781,836
małopolskie,120603,"Iwanowice, gm.",krakowski,6642,3752,3718,2547,1171
małopolskie,120604,"Jerzmanowice-Przeginia, gm.",krakowski,8361,4941,4880,3285,1595
małopolskie,120605,"Kocmyrzów-Luborzyca, gm.",krakowski,10535,5513,5467,3254,2213
małopolskie,120606,"Krzeszowice, gm.",krakowski,26094,15165,15007,7603,7404
małopolskie,120607,"Liszki, gm.",krakowski,12377,7339,7285,4658,2627
małopolskie,120608,"Michałowice, gm.",krakowski,6624,3757,3730,2063,1667
małopolskie,120609,"Mogilany, gm.",krakowski,9013,5502,5450,3035,2415
małopolskie,120610,"Skała, gm.",krakowski,7829,4267,4230,2663,1567
małopolskie,120611,"Skawina, gm.",krakowski,33007,18881,18655,10014,8641
małopolskie,120612,"Słomniki, gm.",krakowski,10862,5696,5654,3644,2010
małopolskie,120613,"Sułoszowa, gm.",krakowski,4654,2734,2711,2100,611
małopolskie,120614,"Świątniki Górne, gm.",krakowski,7177,4102,4068,2492,1576
małopolskie,120615,"Wielka Wieś, gm.",krakowski,7710,4712,4661,2441,2220
małopolskie,120616,"Zabierzów, gm.",krakowski,18785,11882,11744,5528,6216
małopolskie,120617,"Zielonki, gm.",krakowski,13163,8059,7975,3581,4394
małopolskie,120701,"Limanowa, m.",limanowski,12160,7641,7572,4849,2723
małopolskie,120702,"Mszana Dolna, m.",limanowski,6021,3636,3608,2355,1253
małopolskie,120703,"Dobra, gm.",limanowski,7529,4102,4053,2818,1235
małopolskie,120704,"Jodłownik, gm.",limanowski,6393,3426,3390,2505,885
małopolskie,120705,"Kamienica, gm.",limanowski,5673,3422,3403,2551,852
małopolskie,120706,"Laskowa, gm.",limanowski,5746,4025,4000,3478,522
małopolskie,120707,"Limanowa, gm.",limanowski,17825,10846,10757,8554,2203
małopolskie,120708,"Łukowica, gm.",limanowski,7037,4401,4341,3307,1034
małopolskie,120709,"Mszana Dolna, gm.",limanowski,12631,7669,7590,6188,1402
małopolskie,120710,"Niedźwiedź, gm.",limanowski,5260,2681,2662,2031,631
małopolskie,120711,"Słopnice, gm.",limanowski,4338,2758,2731,2291,440
małopolskie,120712,"Tymbark, gm.",limanowski,4727,3092,3063,2442,621
małopolskie,120801,"Charsznica, gm.",miechowski ,6326,2831,2798,1868,930
małopolskie,120802,"Gołcza, gm.",miechowski ,5143,2544,2519,1703,816
małopolskie,120803,"Kozłów, gm.",miechowski ,4089,1835,1809,1307,502
małopolskie,120804,"Książ Wielki, gm.",miechowski ,4494,2366,2331,1636,695
małopolskie,120805,"Miechów, gm.",miechowski ,16211,8233,8141,4488,3653
małopolskie,120806,"Racławice, gm.",miechowski ,2077,849,842,566,276
małopolskie,120807,"Słaboszów, gm.",miechowski ,3121,1373,1354,968,386
małopolskie,120901,"Dobczyce, gm.",myślenicki,11070,6572,6506,4097,2409
małopolskie,120902,"Lubień, gm.",myślenicki,7265,4482,4441,3374,1067
małopolskie,120903,"Myślenice, gm.",myślenicki,32589,20289,20038,11825,8213
małopolskie,120904,"Pcim, gm.",myślenicki,8158,5064,5010,3804,1206
małopolskie,120905,"Raciechowice, gm.",myślenicki,4778,2561,2536,1749,787
małopolskie,120906,"Siepraw, gm.",myślenicki,6166,3626,3594,2383,1211
małopolskie,120907,"Sułkowice, gm.",myślenicki,10870,5900,5837,3602,2235
małopolskie,120908,"Tokarnia, gm.",myślenicki,6401,4066,4030,3048,982
małopolskie,120909,"Wiśniowa, gm.",myślenicki,5409,3420,3383,2586,797
małopolskie,121001,"Grybów, m.",nowosądecki,4972,3240,3197,2281,916
małopolskie,121002,"Chełmiec, gm.",nowosądecki,19072,12097,11984,9091,2893
małopolskie,121003,"Gródek nad Dunajcem, gm.",nowosądecki,7100,4292,4262,3165,1097
małopolskie,121004,"Grybów, gm.",nowosądecki,17406,11826,11744,9777,1967
małopolskie,121005,"Kamionka Wielka, gm.",nowosądecki,6985,4472,4418,3447,971
małopolskie,121006,"Korzenna, gm.",nowosądecki,10183,6296,6241,5214,1027
małopolskie,121007,"Krynica-Zdrój, gm.",nowosądecki,15670,9824,9765,5180,4585
małopolskie,121008,"Łabowa, gm.",nowosądecki,3933,2322,2298,1807,491
małopolskie,121009,"Łącko, gm.",nowosądecki,11602,6933,6862,5267,1595
małopolskie,121010,"Łososina Dolna, gm.",nowosądecki,7837,5193,5163,4240,923
małopolskie,121011,"Muszyna, gm.",nowosądecki,9396,5568,5505,3334,2171
małopolskie,121012,"Nawojowa, gm.",nowosądecki,5850,3680,3638,2884,754
małopolskie,121013,"Piwniczna-Zdrój, gm.",nowosądecki,8606,5089,5052,3505,1547
małopolskie,121014,"Podegrodzie, gm.",nowosądecki,8826,5551,5468,4347,1121
małopolskie,121015,"Rytro, gm.",nowosądecki,3002,1773,1758,1280,478
małopolskie,121016,"Stary Sącz, gm.",nowosądecki,17430,10894,10815,7914,2901
małopolskie,121101,"Nowy Targ, m.",nowotarski,26686,15024,14890,7202,7688
małopolskie,121102,"Szczawnica, gm.",nowotarski,7061,4097,4051,1860,2191
małopolskie,121103,"Czarny Dunajec, gm.",nowotarski,16934,7704,7614,5462,2152
małopolskie,121104,"Czorsztyn, gm.",nowotarski,6102,3417,3373,1702,1671
małopolskie,121105,"Jabłonka, gm.",nowotarski,13318,7696,7642,6043,1599
małopolskie,121106,"Krościenko nad Dunajcem, gm.",nowotarski,5727,3286,3238,1942,1296
małopolskie,121107,"Lipnica Wielka, gm.",nowotarski,4282,2478,2455,1845,610
małopolskie,121108,"Łapsze Niżne, gm.",nowotarski,7258,3678,3635,2281,1354
małopolskie,121109,"Nowy Targ, gm.",nowotarski,17505,9329,9272,6047,3225
małopolskie,121110,"Ochotnica Dolna, gm.",nowotarski,6469,3856,3826,2932,894
małopolskie,121111,"Raba Wyżna, gm.",nowotarski,10788,5968,5899,4211,1688
małopolskie,121112,"Rabka-Zdrój, gm.",nowotarski,14711,8998,8928,5752,3176
małopolskie,121113,"Spytkowice, gm.",nowotarski,3155,1693,1682,1297,385
małopolskie,121114,"Szaflary, gm.",nowotarski,8010,3887,3859,2962,897
małopolskie,121201,"Bukowno, m.",olkuski,8563,4574,4513,2002,2511
małopolskie,121203,"Bolesław, gm.",olkuski,6437,3272,3224,1321,1903
małopolskie,121204,"Klucze, gm.",olkuski,12468,7001,6913,3183,3730
małopolskie,121205,"Olkusz, gm.",olkuski,41092,23896,23552,12616,10936
małopolskie,121206,"Trzyciąż, gm.",olkuski,5725,2893,2856,2154,702
małopolskie,121207,"Wolbrom, gm.",olkuski,18927,10256,10102,6323,3779
małopolskie,121301,"Oświęcim, m.",oświęcimski,33054,19644,19439,8149,11290
małopolskie,121302,"Brzeszcze, gm.",oświęcimski,17342,10390,10249,4820,5429
małopolskie,121303,"Chełmek, gm.",oświęcimski,10281,5953,5874,2820,3054
małopolskie,121304,"Kęty, gm.",oświęcimski,26779,16154,15992,8346,7646
małopolskie,121305,"Osiek, gm.",oświęcimski,6263,3444,3417,2103,1314
małopolskie,121306,"Oświęcim, gm.",oświęcimski,13824,8574,8480,4386,4094
małopolskie,121307,"Polanka Wielka, gm.",oświęcimski,3314,1931,1916,1125,791
małopolskie,121308,"Przeciszów, gm.",oświęcimski,5399,2919,2885,1544,1341
małopolskie,121309,"Zator, gm.",oświęcimski,7371,4337,4282,2459,1823
małopolskie,121401,"Koniusza, gm.",proszowicki,6795,3128,3100,2226,874
małopolskie,121402,"Koszyce, gm.",proszowicki,4799,1919,1892,1273,619
małopolskie,121403,"Nowe Brzesko, gm.",proszowicki,4582,2210,2197,1532,665
małopolskie,121404,"Pałecznica, gm.",proszowicki,2898,1374,1358,1049,309
małopolskie,121405,"Proszowice, gm.",proszowicki,13420,6647,6578,4181,2397
małopolskie,121406,"Radziemice, gm.",proszowicki,2753,1312,1297,931,366
małopolskie,121501,"Jordanów, m.",Suski,4212,2600,2578,1526,1052
małopolskie,121502,"Sucha Beskidzka, m.",Suski,8082,4588,4547,2166,2381
małopolskie,121503,"Budzów, gm.",Suski,6406,3562,3535,2499,1036
małopolskie,121504,"Bystra-Sidzina, gm.",Suski,4982,2786,2754,1960,794
małopolskie,121505,"Jordanów, gm.",Suski,8118,4569,4530,3383,1147
małopolskie,121506,"Maków Podhalański, gm.",Suski,12827,7589,7503,4915,2588
małopolskie,121507,"Stryszawa, gm.",Suski,9669,5461,5369,3589,1780
małopolskie,121508,"Zawoja, gm.",Suski,7527,4457,4424,2664,1760
małopolskie,121509,"Zembrzyce, gm.",Suski,4433,2559,2531,1507,1024
małopolskie,121601,"Ciężkowice, gm.",tarnowski,8741,4597,4550,3125,1425
małopolskie,121602,"Gromnik, gm.",tarnowski,6595,3595,3573,2946,627
małopolskie,121603,"Lisia Góra, gm.",tarnowski,10621,6158,6119,4589,1530
małopolskie,121604,"Pleśna, gm.",tarnowski,9112,5131,5085,3657,1428
małopolskie,121605,"Radłów, gm.",tarnowski,7727,3980,3931,2876,1055
małopolskie,121606,"Ryglice, gm.",tarnowski,8774,4833,4799,3604,1195
małopolskie,121607,"Rzepiennik Strzyżewski, gm.",tarnowski,5304,2861,2837,2228,609
małopolskie,121608,"Skrzyszów, gm.",tarnowski,10286,5821,5762,4020,1742
małopolskie,121609,"Tarnów, gm.",tarnowski,18241,10939,10845,6998,3847
małopolskie,121610,"Tuchów, gm.",tarnowski,13953,8019,7975,5830,2145
małopolskie,121611,"Wierzchosławice, gm.",tarnowski,8199,4932,4880,3244,1636
małopolskie,121612,"Wietrzychowice, gm.",tarnowski,3314,1575,1556,1043,513
małopolskie,121613,"Wojnicz, gm.",tarnowski,10177,5948,5899,4192,1707
małopolskie,121614,"Zakliczyn, gm.",tarnowski,9551,5265,5211,3794,1417
małopolskie,121615,"Żabno, gm.",tarnowski,14976,8105,8036,5737,2299
małopolskie,121616,"Szerzyny, gm.",tarnowski,6453,3512,3478,2633,845
małopolskie,121701,"Zakopane, m.",tatrzański,29754,20713,20554,9561,10993
małopolskie,121702,"Biały Dunajec, gm.",tatrzański,5849,3135,3113,2318,795
małopolskie,121703,"Bukowina Tatrzańska, gm.",tatrzański,11254,6912,6864,4767,2097
małopolskie,121704,"Kościelisko, gm.",tatrzański,7057,3890,3858,2267,1591
małopolskie,121705,"Poronin, gm.",tatrzański,9743,5613,5588,3525,2063
małopolskie,121801,"Andrychów, gm.",wadowicki,34774,20841,20588,11188,9400
małopolskie,121802,"Brzeźnica, gm.",wadowicki,7681,4100,4057,2396,1661
małopolskie,121803,"Kalwaria Zebrzydowska, gm.",wadowicki,15452,8457,8391,4794,3597
małopolskie,121804,"Lanckorona, gm.",wadowicki,4670,2452,2428,1345,1083
małopolskie,121805,"Mucharz, gm.",wadowicki,3121,1756,1742,995,747
małopolskie,121806,"Spytkowice, gm.",wadowicki,7763,4283,4250,2774,1476
małopolskie,121807,"Stryszów, gm.",wadowicki,5317,2851,2818,1675,1143
małopolskie,121808,"Tomice, gm.",wadowicki,5785,3157,3118,1696,1422
małopolskie,121809,"Wadowice, gm.",wadowicki,30523,18215,18020,9203,8817
małopolskie,121810,"Wieprz, gm.",wadowicki,8966,5322,5277,3444,1833
małopolskie,121901,"Biskupice, gm.",wielicki,6955,4140,4072,2720,1352
małopolskie,121902,"Gdów, gm.",wielicki,12777,7314,7226,4510,2716
małopolskie,121903,"Kłaj, gm.",wielicki,7954,4599,4549,2360,2189
małopolskie,121904,"Niepołomice, gm.",wielicki,18338,10911,10800,5864,4936
małopolskie,121905,"Wieliczka, gm.",wielicki,39907,23356,23115,11120,11995
małopolskie,126101,"Kraków, m.",Kraków,590213,372448,368448,147074,221374
małopolskie,126201,"Nowy Sącz, m.",Nowy Sącz,66749,41994,41578,23023,18555
małopolskie,126301,"Tarnów, m.",Tarnów,94243,54709,54107,25716,28391
mazowieckie,140101,"Białobrzegi, gm.",białobrzeski,8236,4973,4938,3015,1923
mazowieckie,140102,"Promna, gm.",białobrzeski,4699,2657,2630,1920,710
mazowieckie,140103,"Radzanów, gm.",białobrzeski,3041,1792,1773,1342,431
mazowieckie,140104,"Stara Błotnica, gm.",białobrzeski,4014,2271,2207,1838,369
mazowieckie,140105,"Stromiec, gm.",białobrzeski,4510,2260,2215,1754,461
mazowieckie,140106,"Wyśmierzyce, gm.",białobrzeski,2427,1411,1402,1138,264
mazowieckie,140201,"Ciechanów, m.",ciechanowski,36991,20934,20662,10764,9898
mazowieckie,140202,"Ciechanów, gm.",ciechanowski,5068,2324,2295,1434,861
mazowieckie,140203,"Glinojeck, gm.",ciechanowski,6459,2918,2879,1783,1096
mazowieckie,140204,"Gołymin-Ośrodek, gm.",ciechanowski,3234,1642,1622,1312,310
mazowieckie,140205,"Grudusk, gm.",ciechanowski,3124,1704,1682,1238,444
mazowieckie,140206,"Ojrzeń, gm.",ciechanowski,3467,1693,1674,1265,409
mazowieckie,140207,"Opinogóra Górna, gm.",ciechanowski,4729,2341,2311,1718,593
mazowieckie,140208,"Regimin, gm.",ciechanowski,3943,1945,1932,1340,592
mazowieckie,140209,"Sońsk, gm.",ciechanowski,6304,3214,3175,2187,988
mazowieckie,140301,"Garwolin, m.",garwoliński,13135,8448,8358,4813,3545
mazowieckie,140302,"Łaskarzew, m.",garwoliński,3833,2304,2274,1586,688
mazowieckie,140303,"Borowie, gm.",garwoliński,4036,2338,2308,1796,512
mazowieckie,140304,"Garwolin, gm.",garwoliński,9376,5704,5651,3861,1790
mazowieckie,140305,"Górzno, gm.",garwoliński,4851,3048,3007,2369,638
mazowieckie,140306,"Łaskarzew, gm.",garwoliński,4162,2411,2381,1794,587
mazowieckie,140307,"Maciejowice, gm.",garwoliński,5996,3416,3386,2607,779
mazowieckie,140308,"Miastków Kościelny, gm.",garwoliński,4044,2292,2262,1654,608
mazowieckie,140309,"Parysów, gm.",garwoliński,3160,1796,1767,1459,308
mazowieckie,140310,"Pilawa, gm.",garwoliński,8259,4708,4664,3176,1488
mazowieckie,140311,"Sobolew, gm.",garwoliński,6448,3768,3705,2878,827
mazowieckie,140312,"Trojanów, gm.",garwoliński,6111,3651,3615,2916,699
mazowieckie,140313,"Wilga, gm.",garwoliński,4653,2770,2726,1484,1242
mazowieckie,140314,"Żelechów, gm.",garwoliński,6736,4157,4102,3149,953
mazowieckie,140401,"Gostynin, m.",gostyniński,15618,8706,8566,4439,4127
mazowieckie,140402,"Gostynin, gm.",gostyniński,9739,4781,4720,3142,1578
mazowieckie,140403,"Pacyna, gm.",gostyniński,3184,1531,1508,1164,344
mazowieckie,140404,"Sanniki, gm.",gostyniński,5234,2647,2613,2003,610
mazowieckie,140405,"Szczawin Kośc., gm.",gostyniński,4194,1946,1922,1375,547
mazowieckie,140501,"Milanówek, m.",grodziski,12473,8302,8192,3392,4800
mazowieckie,140502,"Podkowa Leśna, m.",grodziski,3126,2323,2293,825,1468
mazowieckie,140503,"Baranów, gm.",grodziski,3881,1977,1959,1284,675
mazowieckie,140504,"Grodzisk Mazowiecki, gm.",grodziski,31428,19361,19160,8662,10498
mazowieckie,140505,"Jaktorów, gm.",grodziski,8288,4850,4802,2359,2443
mazowieckie,140506,"Żabia Wola, gm.",grodziski,5628,3269,3241,1621,1620
mazowieckie,140601,"Belsk Duży, gm.",grójecki,5305,3153,3117,2176,941
mazowieckie,140602,"Błędów, gm.",grójecki,6454,3702,3676,2814,862
mazowieckie,140603,"Chynów, gm.",grójecki,7604,4222,4172,2700,1472
mazowieckie,140604,"Goszczyn, gm.",grójecki,2328,1492,1481,1243,238
mazowieckie,140605,"Grójec, gm.",grójecki,19312,11252,11096,5337,5759
mazowieckie,140606,"Jasieniec, gm.",grójecki,4300,2269,2246,1524,722
mazowieckie,140607,"Mogielnica, gm.",grójecki,7526,4336,4290,3158,1132
mazowieckie,140608,"Nowe Miasto nad Pilicą, gm.",grójecki,7222,4552,4504,3326,1178
mazowieckie,140609,"Pniewy, gm.",grójecki,3741,2080,2059,1423,636
mazowieckie,140611,"Warka, gm.",grójecki,15027,8992,8894,5859,3035
mazowieckie,140701,"Garbatka-Letnisko, gm.",kozienicki,4878,2743,2717,1616,1101
mazowieckie,140702,"Głowaczów, gm.",kozienicki,6270,3336,3302,2591,711
mazowieckie,140703,"Gniewoszów, gm.",kozienicki,3445,1827,1803,1330,473
mazowieckie,140704,"Grabów nad Pilicą, gm.",kozienicki,3179,1758,1756,1385,371
mazowieckie,140705,"Kozienice, gm.",kozienicki,25426,14520,14302,8933,5369
mazowieckie,140706,"Magnuszew, gm.",kozienicki,5614,3347,3313,2476,837
mazowieckie,140707,"Sieciechów, gm.",kozienicki,3352,1742,1723,1309,414
mazowieckie,140801,"Legionowo, m.",legionowski,39528,25123,24817,10850,13967
mazowieckie,140802,"Jabłonna, gm.",legionowski,11347,7564,7488,3066,4422
mazowieckie,140803,"Nieporęt, gm.",legionowski,9608,6383,6302,2910,3392
mazowieckie,140804,"Serock, gm.",legionowski,10419,6283,6223,2803,3420
mazowieckie,140805,"Wieliszew, gm.",legionowski,8508,5374,5320,2611,2709
mazowieckie,140901,"Chotcza, gm.",lipski,2209,965,957,710,247
mazowieckie,140902,"Ciepielów, gm.",lipski,4776,2263,2214,1587,627
mazowieckie,140903,"Lipsko, gm.",lipski,9983,4904,4843,3016,1827
mazowieckie,140904,"Rzeczniów, gm.",lipski,3853,1901,1882,1470,412
mazowieckie,140905,"Sienno, gm.",lipski,5243,2462,2433,1731,702
mazowieckie,140906,"Solec nad Wisłą, gm.",lipski,4629,2049,2020,1319,701
mazowieckie,141001,"Huszlew, gm.",łosicki,2423,1369,1360,1129,231
mazowieckie,141002,"Łosice, gm.",łosicki,9233,5074,4994,3142,1852
mazowieckie,141003,"Olszanka, gm.",łosicki,2522,1521,1512,1205,307
mazowieckie,141004,"Platerów, gm.",łosicki,4303,2222,2191,1535,656
mazowieckie,141005,"Sarnaki, gm.",łosicki,4536,2621,2591,1623,968
mazowieckie,141006,"Stara Kornica, gm.",łosicki,3991,2097,2073,1626,447
mazowieckie,141101,"Maków Mazowiecki, m.",makowski,8197,4400,4330,2461,1869
mazowieckie,141102,"Czerwonka, gm.",makowski,2098,1137,1128,892,236
mazowieckie,141103,"Karniewo, gm.",makowski,4237,2287,2260,1783,477
mazowieckie,141104,"Krasnosielc, gm.",makowski,5268,2718,2678,1788,890
mazowieckie,141105,"Młynarze, gm.",makowski,1436,878,870,674,196
mazowieckie,141106,"Płoniawy-Bramura, gm.",makowski,4754,2388,2364,1819,545
mazowieckie,141107,"Różan, gm.",makowski,3946,2315,2302,1417,885
mazowieckie,141108,"Rzewnie, gm.",makowski,2385,1435,1419,1042,377
mazowieckie,141109,"Sypniewo, gm.",makowski,2884,1606,1588,1194,394
mazowieckie,141110,"Szelków, gm.",makowski,3121,1805,1785,1335,450
mazowieckie,141201,"Mińsk Mazowiecki, m.",miński,29776,18964,18692,8480,10212
mazowieckie,141204,"Cegłów, gm.",miński,5008,2884,2834,1560,1274
mazowieckie,141205,"Dębe Wielkie, gm.",miński,6779,3842,3786,2369,1417
mazowieckie,141206,"Dobre, gm.",miński,4950,2726,2690,1780,910
mazowieckie,141207,"Halinów, gm.",miński,10408,6386,6341,3389,2952
mazowieckie,141208,"Jakubów, gm.",miński,3960,2199,2175,1550,625
mazowieckie,141209,"Kałuszyn, gm.",miński,4798,2681,2650,1844,806
mazowieckie,141210,"Latowicz, gm.",miński,4290,2033,2007,1474,533
mazowieckie,141211,"Mińsk Mazowiecki, gm.",miński,10383,6057,5987,3645,2342
mazowieckie,141212,"Mrozy, gm.",miński,7167,3841,3789,2283,1506
mazowieckie,141213,"Siennica, gm.",miński,5732,3143,3106,1946,1160
mazowieckie,141214,"Stanisławów, gm.",miński,5163,2970,2942,2034,908
mazowieckie,141215,"Sulejówek, m.",miński,14677,9824,9701,4849,4852
mazowieckie,141301,"Mława, m.",mławski,24145,12776,12606,6397,6209
mazowieckie,141302,"Dzierzgowo, gm.",mławski,2739,1338,1326,1019,307
mazowieckie,141303,"Lipowiec Kościelny, gm.",mławski,3868,1750,1735,1213,522
mazowieckie,141304,"Radzanów, gm.",mławski,2823,1375,1360,1046,314
mazowieckie,141305,"Strzegowo, gm.",mławski,6471,3161,3112,2168,944
mazowieckie,141306,"Stupsk, gm.",mławski,4052,2013,1998,1358,640
mazowieckie,141307,"Szreńsk, gm.",mławski,3489,1778,1760,1407,353
mazowieckie,141308,"Szydłowo, gm.",mławski,3700,1690,1668,1129,539
mazowieckie,141309,"Wieczfnia Kościelna, gm.",mławski,3257,1552,1523,1143,380
mazowieckie,141310,"Wiśniewo, gm.",mławski,4140,1913,1892,1314,578
mazowieckie,141401,"Nowy Dwór Mazowiecki, m.",nowodworski,21717,12339,12199,5121,7078
mazowieckie,141402,"Czosnów, gm.",nowodworski,7544,4426,4380,2323,2057
mazowieckie,141403,"Leoncin, gm.",nowodworski,4361,2490,2473,1554,919
mazowieckie,141404,"Nasielsk, gm.",nowodworski,15458,7922,7812,4846,2966
mazowieckie,141405,"Pomiechówek, gm.",nowodworski,7288,4388,4317,2351,1966
mazowieckie,141406,"Zakroczym, gm.",nowodworski,5000,2370,2347,1366,981
mazowieckie,141501,"Baranowo, gm.",ostrołęcki,5422,2644,2625,1644,981
mazowieckie,141502,"Czarnia, gm.",ostrołęcki,2061,918,904,690,214
mazowieckie,141503,"Czerwin, gm.",ostrołęcki,4164,2369,2338,1910,428
mazowieckie,141504,"Goworowo, gm.",ostrołęcki,7131,3356,3321,2414,907
mazowieckie,141505,"Kadzidło, gm.",ostrołęcki,8645,4224,4165,2720,1445
mazowieckie,141506,"Lelis, gm.",ostrołęcki,6503,3585,3546,2592,954
mazowieckie,141507,"Łyse, gm.",ostrołęcki,6398,2915,2883,1882,1001
mazowieckie,141508,"Myszyniec, gm.",ostrołęcki,8092,4061,4018,2819,1199
mazowieckie,141509,"Olszewo-Borki, gm.",ostrołęcki,7584,4191,4145,2772,1373
mazowieckie,141510,"Rzekuń, gm.",ostrołęcki,7698,4382,4339,2796,1543
mazowieckie,141511,"Troszyn, gm.",ostrołęcki,3940,2117,2100,1625,475
mazowieckie,141601,"Ostrów Mazowiecka, m.",ostrowski,18209,9980,9881,5785,4096
mazowieckie,141602,"Andrzejewo, gm.",ostrowski,3611,2190,2176,1887,289
mazowieckie,141603,"Boguty-Pianki, gm.",ostrowski,2281,1561,1549,1269,280
mazowieckie,141604,"Brok, gm.",ostrowski,2691,1705,1683,1020,663
mazowieckie,141605,"Małkinia Górna, gm.",ostrowski,9902,5460,5423,3838,1585
mazowieckie,141606,"Nur, gm.",ostrowski,2685,1651,1630,1288,342
mazowieckie,141607,"Ostrów Mazowiecka, gm.",ostrowski,10012,5233,5181,3854,1327
mazowieckie,141608,"Stary Lubotyń, gm.",ostrowski,3088,1762,1735,1477,258
mazowieckie,141609,"Szulborze Wielkie, gm.",ostrowski,1498,836,823,663,160
mazowieckie,141610,"Wąsewo, gm.",ostrowski,3678,1841,1826,1364,462
mazowieckie,141611,"Zaręby Kościelne, gm.",ostrowski,3109,1707,1693,1397,296
mazowieckie,141701,"Józefów, m.",otwocki,13817,9503,9399,4303,5096
mazowieckie,141702,"Otwock, m.",otwocki,34335,22347,22092,10991,11101
mazowieckie,141703,"Celestynów, gm.",otwocki,8870,5809,5727,3554,2173
mazowieckie,141704,"Karczew, gm.",otwocki,12680,8026,7937,4685,3252
mazowieckie,141705,"Kołbiel, gm.",otwocki,6596,4002,3955,2577,1378
mazowieckie,141706,"Osieck, gm.",otwocki,2898,1794,1769,1300,469
mazowieckie,141707,"Sobienie-Jeziory, gm.",otwocki,5125,2990,2950,1907,1043
mazowieckie,141708,"Wiązowna, gm.",otwocki,8116,5308,5264,2918,2346
mazowieckie,141801,"Góra Kalwaria, gm.",piaseczyński,19801,11372,11238,5630,5608
mazowieckie,141802,"Konstancin-Jeziorna, gm.",piaseczyński,19108,12572,12403,5403,7000
mazowieckie,141803,"Lesznowola, gm.",piaseczyński,13744,9348,9264,3798,5466
mazowieckie,141804,"Piaseczno, gm.",piaseczyński,49143,33249,32866,12352,20514
mazowieckie,141805,"Prażmów, gm.",piaseczyński,7113,4238,4174,2119,2055
mazowieckie,141806,"Tarczyn, gm.",piaseczyński,8587,5306,5257,3198,2059
mazowieckie,141901,"Bielsk, gm.",płocki,6976,3494,3461,2479,982
mazowieckie,141902,"Bodzanów, gm.",płocki,6641,3143,3121,2192,929
mazowieckie,141903,"Brudzeń Duży, gm.",płocki,6202,2991,2951,2195,756
mazowieckie,141904,"Bulkowo, gm.",płocki,4577,2265,2249,1773,476
mazowieckie,141905,"Drobin, gm.",płocki,6568,2874,2835,2067,768
mazowieckie,141906,"Gąbin, gm.",płocki,8845,4697,4646,3264,1382
mazowieckie,141907,"Łąck, gm.",płocki,4118,2126,2082,1313,769
mazowieckie,141908,"Mała Wieś, gm.",płocki,4981,2223,2191,1512,679
mazowieckie,141909,"Nowy Duninów, gm.",płocki,3233,1636,1619,1023,596
mazowieckie,141910,"Radzanowo, gm.",płocki,6021,2989,2965,1942,1023
mazowieckie,141911,"Słubice, gm.",płocki,3648,1794,1777,1424,353
mazowieckie,141912,"Słupno, gm.",płocki,4823,2701,2684,1306,1378
mazowieckie,141913,"Stara Biała, gm.",płocki,8066,4282,4217,2629,1588
mazowieckie,141914,"Staroźreby, gm.",płocki,5866,2745,2717,2008,709
mazowieckie,141915,"Wyszogród, gm.",płocki,4865,2365,2343,1472,871
mazowieckie,142001,"Płońsk, m.",płoński,18186,10060,9924,4885,5039
mazowieckie,142002,"Raciąż, m.",płoński,3630,1921,1903,1235,668
mazowieckie,142003,"Baboszewo, gm.",płoński,6366,3242,3210,2403,807
mazowieckie,142004,"Czerwińsk nad Wisłą, gm.",płoński,6431,2718,2692,1929,763
mazowieckie,142005,"Dzierzążnia, gm.",płoński,3139,1594,1568,1171,397
mazowieckie,142006,"Joniec, gm.",płoński,2471,1413,1396,779,617
mazowieckie,142007,"Naruszewo, gm.",płoński,5334,2266,2233,1570,663
mazowieckie,142008,"Nowe Miasto, gm.",płoński,4002,2062,2039,1288,751
mazowieckie,142009,"Płońsk, gm.",płoński,5704,2700,2673,1779,894
mazowieckie,142010,"Raciąż, gm.",płoński,7077,3351,3298,2703,595
mazowieckie,142011,"Sochocin, gm.",płoński,4931,2567,2541,1618,923
mazowieckie,142012,"Załuski, gm.",płoński,4469,2144,2117,1531,586
mazowieckie,142101,"Piastów, m.",pruszkowski,17791,11801,11680,5437,6243
mazowieckie,142102,"Pruszków, m.",pruszkowski,45054,28080,27691,11808,15883
mazowieckie,142103,"Brwinów, gm.",pruszkowski,17580,11610,11468,4888,6580
mazowieckie,142104,"Michałowice, gm.",pruszkowski,12097,8639,8532,3420,5112
mazowieckie,142105,"Nadarzyn, gm.",pruszkowski,8253,5364,5303,2421,2882
mazowieckie,142106,"Raszyn, gm.",pruszkowski,15595,10420,10292,5547,4745
mazowieckie,142201,"Przasnysz, m.",przasnyski,13869,7777,7678,4384,3294
mazowieckie,142202,"Chorzele, gm.",przasnyski,8118,4039,4001,2810,1191
mazowieckie,142203,"Czernice Borowe, gm.",przasnyski,3138,1667,1657,1300,357
mazowieckie,142204,"Jednorożec, gm.",przasnyski,5616,2583,2547,1769,778
mazowieckie,142205,"Krasne, gm.",przasnyski,3131,1504,1489,1091,398
mazowieckie,142206,"Krzynowłoga Mała, gm.",przasnyski,2943,1749,1722,1496,226
mazowieckie,142207,"Przasnysz, gm.",przasnyski,5766,3057,3021,2350,671
mazowieckie,142301,"Borkowice, gm.",przysuski,3790,1888,1842,1197,645
mazowieckie,142302,"Gielniów, gm.",przysuski,4006,2341,2302,1821,481
mazowieckie,142303,"Klwów, gm.",przysuski,2955,1854,1831,1544,287
mazowieckie,142304,"Odrzywół, gm.",przysuski,3443,2303,2286,1912,374
mazowieckie,142305,"Potworów, gm.",przysuski,3351,1867,1845,1547,298
mazowieckie,142306,"Przysucha, gm.",przysuski,10677,6181,6118,4063,2055
mazowieckie,142307,"Rusinów, gm.",przysuski,3565,2335,2307,1966,341
mazowieckie,142308,"Wieniawa, gm.",przysuski,4390,2481,2468,1950,518
mazowieckie,142401,"Gzy, gm.",pułtuski,3162,1574,1555,1171,384
mazowieckie,142402,"Obryte, gm.",pułtuski,4026,2448,2416,1768,648
mazowieckie,142403,"Pokrzywnica, gm.",pułtuski,3920,1912,1883,1304,579
mazowieckie,142404,"Pułtusk, gm.",pułtuski,18944,10581,10426,5824,4602
mazowieckie,142405,"Świercze, gm.",pułtuski,3732,1793,1773,1185,588
mazowieckie,142406,"Winnica, gm.",pułtuski,3216,1874,1851,1303,548
mazowieckie,142407,"Zatory, gm.",pułtuski,3933,2257,2243,1614,629
mazowieckie,142501,"Pionki, m.",radomski,16513,8901,8777,4644,4133
mazowieckie,142502,"Gózd, gm.",radomski,6198,3723,3692,3119,573
mazowieckie,142503,"Iłża, gm.",radomski,12705,6320,6221,4180,2041
mazowieckie,142504,"Jastrzębia, gm.",radomski,5087,2765,2725,2043,682
mazowieckie,142505,"Jedlińsk, gm.",radomski,10325,5610,5537,4140,1397
mazowieckie,142506,"Jedlnia-Letnisko, gm.",radomski,9407,5620,5560,3862,1698
mazowieckie,142507,"Kowala, gm.",radomski,8307,4887,4830,3552,1278
mazowieckie,142508,"Pionki, gm.",radomski,8046,4144,4095,2953,1142
mazowieckie,142509,"Przytyk, gm.",radomski,5484,3268,3250,2709,541
mazowieckie,142510,"Skaryszew, gm.",radomski,10439,6123,6071,4983,1088
mazowieckie,142511,"Wierzbica, gm.",radomski,7933,4161,4120,3166,954
mazowieckie,142512,"Wolanów, gm.",radomski,6374,3718,3682,2969,713
mazowieckie,142513,"Zakrzew, gm.",radomski,8801,5460,5413,4330,1083
mazowieckie,142601,"Domanice, gm.",siedlecki,2098,1308,1294,1066,228
mazowieckie,142602,"Korczew, gm.",siedlecki,2542,1364,1341,930,411
mazowieckie,142603,"Kotuń, gm.",siedlecki,6683,3622,3581,2433,1148
mazowieckie,142604,"Mokobody, gm.",siedlecki,4135,2516,2490,2057,433
mazowieckie,142605,"Mordy, gm.",siedlecki,5010,2784,2770,2105,665
mazowieckie,142606,"Paprotnia, gm.",siedlecki,2172,1411,1402,1212,190
mazowieckie,142607,"Przesmyki, gm.",siedlecki,2997,1714,1699,1365,334
mazowieckie,142608,"Siedlce, gm.",siedlecki,12696,7341,7274,5002,2272
mazowieckie,142609,"Skórzec, gm.",siedlecki,5692,3357,3342,2674,668
mazowieckie,142610,"Suchożebry, gm.",siedlecki,3762,2137,2102,1587,515
mazowieckie,142611,"Wiśniew, gm.",siedlecki,4453,2776,2738,2278,460
mazowieckie,142612,"Wodynie, gm.",siedlecki,3790,2136,2119,1695,424
mazowieckie,142613,"Zbuczyn, gm.",siedlecki,7809,4936,4893,4055,838
mazowieckie,142701,"Sierpc, m.",sierpecki,15269,8133,8052,4420,3632
mazowieckie,142702,"Gozdowo, gm.",sierpecki,4678,2150,2119,1536,583
mazowieckie,142703,"Mochowo, gm.",sierpecki,4765,2268,2234,1680,554
mazowieckie,142704,"Rościszewo, gm.",sierpecki,3350,1874,1853,1515,338
mazowieckie,142705,"Sierpc, gm.",sierpecki,5436,2507,2470,1763,707
mazowieckie,142706,"Szczutowo, gm.",sierpecki,3667,1763,1733,1199,534
mazowieckie,142707,"Zawidz, gm.",sierpecki,5418,2935,2911,2250,661
mazowieckie,142801,"Sochaczew, m.",sochaczewski,30231,16883,16687,8409,8278
mazowieckie,142802,"Brochów, gm.",sochaczewski,3515,1782,1757,1195,562
mazowieckie,142803,"Iłów, gm.",sochaczewski,5044,2781,2757,2174,583
mazowieckie,142804,"Młodzieszyn, gm.",sochaczewski,4381,2155,2126,1610,516
mazowieckie,142805,"Nowa Sucha, gm.",sochaczewski,4895,2574,2527,1744,783
mazowieckie,142806,"Rybno, gm.",sochaczewski,2719,1407,1389,1097,292
mazowieckie,142807,"Sochaczew, gm.",sochaczewski,7371,3818,3772,2547,1225
mazowieckie,142808,"Teresin, gm.",sochaczewski,8711,4944,4881,3081,1800
mazowieckie,142901,"Sokołów Podlaski, m.",sokołowski,15334,9257,9153,5178,3975
mazowieckie,142902,"Bielany, gm.",sokołowski,3087,2082,2069,1834,235
mazowieckie,142903,"Ceranów, gm.",sokołowski,2110,1171,1159,921,238
mazowieckie,142904,"Jabłonna Lacka, gm.",sokołowski,4155,2441,2417,1863,554
mazowieckie,142905,"Kosów Lacki, gm.",sokołowski,5569,3264,3238,2462,776
mazowieckie,142906,"Repki, gm.",sokołowski,4694,2950,2930,2307,623
mazowieckie,142907,"Sabnie, gm.",sokołowski,3324,1976,1960,1369,591
mazowieckie,142908,"Sokołów Podlaski, gm.",sokołowski,4974,2884,2858,2153,705
mazowieckie,142909,"Sterdyń, gm.",sokołowski,3831,2256,2224,1560,664
mazowieckie,143001,"Chlewiska, gm.",szydłowiecki,5295,2642,2612,1977,635
mazowieckie,143002,"Jastrząb, gm.",szydłowiecki,4033,2098,2070,1602,468
mazowieckie,143003,"Mirów, gm.",szydłowiecki,2961,1534,1522,1287,235
mazowieckie,143004,"Orońsko, gm.",szydłowiecki,4556,2520,2486,1905,581
mazowieckie,143005,"Szydłowiec, gm.",szydłowiecki,15570,8344,8260,5582,2678
mazowieckie,143201,"Błonie, gm.",warszawski zachodni,15847,9451,9314,4635,4679
mazowieckie,143202,"Izabelin, gm.",warszawski zachodni,7473,5234,5174,2432,2742
mazowieckie,143203,"Kampinos, gm.",warszawski zachodni,3274,1934,1904,1164,740
mazowieckie,143204,"Leszno, gm.",warszawski zachodni,7214,4138,4113,1979,2134
mazowieckie,143205,"Łomianki, gm.",warszawski zachodni,16919,11913,11766,4946,6820
mazowieckie,143206,"Ożarów Mazowiecki, gm.",warszawski zachodni,16296,10039,9943,5217,4726
mazowieckie,143207,"Stare Babice, gm.",warszawski zachodni,12090,7784,7684,3463,4221
mazowieckie,143301,"Węgrów, m.",węgrowski,10366,6143,6056,3078,2978
mazowieckie,143302,"Grębków, gm.",węgrowski,3790,1994,1970,1557,413
mazowieckie,143303,"Korytnica, gm.",węgrowski,5405,3009,2967,2289,678
mazowieckie,143304,"Liw, gm.",węgrowski,6253,3595,3559,2439,1120
mazowieckie,143305,"Łochów, gm.",węgrowski,14575,8244,8159,5558,2601
mazowieckie,143306,"Miedzna, gm.",węgrowski,3546,2138,2110,1585,525
mazowieckie,143307,"Sadowne, gm.",węgrowski,5163,2812,2791,1874,917
mazowieckie,143308,"Stoczek, gm.",węgrowski,4363,2494,2475,1812,663
mazowieckie,143309,"Wierzbno, gm.",węgrowski,2561,1413,1396,1043,353
mazowieckie,143401,"Kobyłka, m.",wołomiński,14468,9698,9572,5387,4185
mazowieckie,143402,"Marki, m.",wołomiński,19018,11220,11098,5753,5345
mazowieckie,143403,"Ząbki, m.",wołomiński,19348,12271,12149,5974,6175
mazowieckie,143404,"Zielonka, m.",wołomiński,13084,8844,8747,4430,4317
mazowieckie,143405,"Dąbrówka, gm.",wołomiński,5855,3867,3832,2901,931
mazowieckie,143406,"Jadów, gm.",wołomiński,6606,3528,3494,2170,1324
mazowieckie,143407,"Klembów, gm.",wołomiński,6952,4247,4212,2971,1241
mazowieckie,143408,"Poświętne, gm.",wołomiński,4642,2553,2511,2049,462
mazowieckie,143409,"Radzymin, gm.",wołomiński,16764,10449,10349,6516,3833
mazowieckie,143410,"Strachówka, gm.",wołomiński,2434,1182,1167,844,323
mazowieckie,143411,"Tłuszcz, gm.",wołomiński,14575,8445,8347,5523,2824
mazowieckie,143412,"Wołomin, gm.",wołomiński,38969,25033,24771,13908,10863
mazowieckie,143501,"Brańszczyk, gm.",wyszkowski,6927,3933,3897,2697,1200
mazowieckie,143502,"Długosiodło, gm.",wyszkowski,6200,3242,3205,2262,943
mazowieckie,143503,"Rząśnik, gm.",wyszkowski,5522,3391,3367,2636,731
mazowieckie,143504,"Somianka, gm.",wyszkowski,4871,3003,2957,1971,986
mazowieckie,143505,"Wyszków, gm.",wyszkowski,30710,18235,18000,10586,7414
mazowieckie,143506,"Zabrodzie, gm.",wyszkowski,4584,2621,2595,1871,724
mazowieckie,143601,"Kazanów, gm.",zwoleński,3725,2055,2031,1537,494
mazowieckie,143602,"Policzna, gm.",zwoleński,4844,2329,2299,1677,622
mazowieckie,143603,"Przyłęk, gm.",zwoleński,5190,2564,2544,2066,478
mazowieckie,143604,"Tczów, gm.",zwoleński,3776,2017,1976,1656,320
mazowieckie,143605,"Zwoleń, gm.",zwoleński,12355,6966,6881,4753,2128
mazowieckie,143701,"Bieżuń, gm.",żuromiński,4290,2210,2186,1603,583
mazowieckie,143702,"Kuczbork-Osada, gm.",żuromiński,3995,1915,1884,1212,672
mazowieckie,143703,"Lubowidz, gm.",żuromiński,5869,2783,2756,1732,1024
mazowieckie,143704,"Lutocin, gm.",żuromiński,3714,1836,1827,1443,384
mazowieckie,143705,"Siemiątkowo, gm.",żuromiński,2924,1377,1357,1092,265
mazowieckie,143706,"Żuromin, gm.",żuromiński,11747,6037,5981,3517,2464
mazowieckie,143801,"Żyrardów, m.",żyrardowski,32213,18893,18659,8566,10093
mazowieckie,143802,"Mszczonów, gm.",żyrardowski,9031,4921,4874,3112,1762
mazowieckie,143803,"Puszcza Mariańska, gm.",żyrardowski,6693,3540,3503,2061,1442
mazowieckie,143804,"Radziejowice, gm.",żyrardowski,4173,2514,2492,1385,1107
mazowieckie,143805,"Wiskitki, gm.",żyrardowski,7532,3844,3781,2519,1262
mazowieckie,146101,"Ostrołęka, m.",Ostrołęka,42576,24751,24424,13248,11176
mazowieckie,146201,"Płock, m.",Płock,100192,57995,57260,26577,30683
mazowieckie,146301,"Radom, m.",Radom,176120,104893,103661,56923,46738
mazowieckie,146401,"Siedlce, m.",Siedlce,60183,37262,36831,20124,16707
mazowieckie,146502,Bemowo,Warszawa,83996,59161,58342,19347,38995
mazowieckie,146503,Białołęka,Warszawa,61948,42667,42033,13446,28587
mazowieckie,146504,Bielany,Warszawa,104710,70037,69159,27623,41536
mazowieckie,146505,Mokotów,Warszawa,176259,119237,117326,38684,78642
mazowieckie,146506,Ochota,Warszawa,67599,44868,44229,15740,28489
mazowieckie,146507,Praga-Południe,Warszawa,142690,93872,92504,34698,57806
mazowieckie,146508,Praga-Północ,Warszawa,54168,31591,31103,13710,17393
mazowieckie,146509,Rembertów,Warszawa,16981,11353,11212,4268,6944
mazowieckie,146510,Śródmieście,Warszawa,100406,66507,65381,24186,41195
mazowieckie,146511,Targówek,Warszawa,95495,60677,59918,25461,34457
mazowieckie,146512,Ursus,Warszawa,37651,25279,24994,10154,14840
mazowieckie,146513,Ursynów,Warszawa,107730,77025,75847,21936,53911
mazowieckie,146514,Wawer,Warszawa,51102,35083,34644,14977,19667
mazowieckie,146515,Wesoła,Warszawa,15363,10881,10745,4149,6596
mazowieckie,146516,Wilanów,Warszawa,14115,10347,10233,3167,7066
mazowieckie,146517,Włochy,Warszawa,28753,19075,18836,7241,11595
mazowieckie,146518,Wola,Warszawa,108148,69027,68083,26928,41155
mazowieckie,146519,Żoliborz,Warszawa,37393,26157,25784,9500,16284
mazowieckie,149901,Zagranica,Zagranica,277016,203598,201586,79975,121611
opolskie,160101,"Brzeg, m.",brzeski,30407,16405,16180,6638,9542
opolskie,160102,"Skarbimierz, gm.",brzeski,5527,2969,2934,1524,1410
opolskie,160103,"Grodków, gm.",brzeski,15645,7286,7188,3066,4122
opolskie,160104,"Lewin Brzeski, gm.",brzeski,10582,5045,4985,2195,2790
opolskie,160105,"Lubsza, gm.",brzeski,7225,3585,3535,1794,1741
opolskie,160106,"Olszanka, gm.",brzeski,3964,1991,1966,1066,900
opolskie,160201,"Baborów, gm.",głubczycki,5192,2137,2108,975,1133
opolskie,160202,"Branice, gm.",głubczycki,6146,2599,2559,1225,1334
opolskie,160203,"Głubczyce, gm.",głubczycki,19313,9685,9577,4568,5009
opolskie,160204,"Kietrz, gm.",głubczycki,9152,4509,4452,2137,2315
opolskie,160301,"Kędzierzyn-Koźle, m.",kędzierzyńsko-kozielski,51033,26574,26259,7848,18411
opolskie,160302,"Bierawa, gm.",kędzierzyńsko-kozielski,6241,2444,2411,728,1683
opolskie,160303,"Cisek, gm.",kędzierzyńsko-kozielski,4892,1834,1808,441,1367
opolskie,160304,"Pawłowiczki, gm.",kędzierzyńsko-kozielski,6678,2435,2405,789,1616
opolskie,160305,"Polska Cerekiew, gm.",kędzierzyńsko-kozielski,3735,1489,1463,338,1125
opolskie,160306,"Reńska Wieś, gm.",kędzierzyńsko-kozielski,6761,2445,2410,624,1786
opolskie,160401,"Byczyna, gm.",kluczborski,7689,3488,3456,1576,1880
opolskie,160402,"Kluczbork, gm.",kluczborski,30530,14676,14515,5189,9326
opolskie,160403,"Lasowice Wielkie, gm.",kluczborski,5886,2040,2020,551,1469
opolskie,160404,"Wołczyn, gm.",kluczborski,11215,5114,5050,2340,2710
opolskie,160501,"Gogolin, gm.",krapkowicki,10256,3562,3507,887,2620
opolskie,160502,"Krapkowice, gm.",krapkowicki,19344,8316,8217,2107,6110
opolskie,160503,"Strzeleczki, gm.",krapkowicki,6214,2189,2160,435,1725
opolskie,160504,"Walce, gm.",krapkowicki,4678,1576,1546,311,1235
opolskie,160505,"Zdzieszowice, gm.",krapkowicki,13279,5297,5245,1350,3895
opolskie,160601,"Domaszowice, gm.",namysłowski,3033,1696,1676,818,858
opolskie,160602,"Namysłów, gm.",namysłowski,20822,10997,10903,4743,6160
opolskie,160603,"Pokój, gm.",namysłowski,4343,1794,1775,538,1237
opolskie,160604,"Świerczów, gm.",namysłowski,2936,1528,1515,680,835
opolskie,160605,"Wilków, gm.",namysłowski,3630,1709,1692,822,870
opolskie,160701,"Głuchołazy, gm.",nyski,21559,10376,10263,4314,5949
opolskie,160702,"Kamiennik, gm.",nyski,2952,1325,1309,766,543
opolskie,160703,"Korfantów, gm.",nyski,7898,3017,2976,1488,1488
opolskie,160704,"Łambinowice, gm.",nyski,6212,2738,2691,1217,1474
opolskie,160705,"Nysa, gm.",nyski,48998,25151,24877,10583,14294
opolskie,160706,"Otmuchów, gm.",nyski,11955,5799,5741,2791,2950
opolskie,160707,"Paczków, gm.",nyski,10976,5162,5103,2331,2772
opolskie,160708,"Pakosławice, gm.",nyski,3027,1462,1440,872,568
opolskie,160709,"Skoroszyce, gm.",nyski,5109,2152,2130,1139,991
opolskie,160801,"Dobrodzień, gm.",oleski,8247,2968,2932,860,2072
opolskie,160802,"Gorzów Śląski, gm.",oleski,6118,2156,2128,865,1263
opolskie,160803,"Olesno, gm.",oleski,15056,6370,6279,1831,4448
opolskie,160804,"Praszka, gm.",oleski,11702,6068,5956,2717,3239
opolskie,160805,"Radłów, gm.",oleski,3614,1127,1112,398,714
opolskie,160806,"Rudniki, gm.",oleski,6861,3226,3191,1661,1530
opolskie,160807,"Zębowice, gm.",oleski,3100,1068,1054,326,728
opolskie,160901,"Chrząstowice, gm.",opolski,5420,2232,2191,510,1681
opolskie,160902,"Dąbrowa, gm.",opolski,7560,3424,3383,939,2444
opolskie,160903,"Dobrzeń Wielki, gm.",opolski,11685,4839,4783,1115,3668
opolskie,160904,"Komprachcice, gm.",opolski,8859,3738,3684,768,2916
opolskie,160905,"Łubniany, gm.",opolski,7720,3050,3026,538,2488
opolskie,160906,"Murów, gm.",opolski,4666,1754,1736,347,1389
opolskie,160907,"Niemodlin, gm.",opolski,10741,5045,4992,2010,2982
opolskie,160908,"Ozimek, gm.",opolski,17147,6796,6730,1902,4828
opolskie,160909,"Popielów, gm.",opolski,6871,2594,2569,803,1766
opolskie,160910,"Prószków, gm.",opolski,7818,3105,3059,730,2329
opolskie,160911,"Tarnów Opolski, gm.",opolski,7831,3013,2989,758,2231
opolskie,160912,"Tułowice, gm.",opolski,4324,2121,2086,740,1346
opolskie,160913,"Turawa, gm.",opolski,7889,3184,3140,656,2484
opolskie,161001,"Biała, gm.",prudnicki,9102,3284,3253,854,2399
opolskie,161002,"Głogówek, gm.",prudnicki,11150,4401,4361,1436,2925
opolskie,161003,"Lubrza, gm.",prudnicki,3557,1826,1807,807,1000
opolskie,161004,"Prudnik, gm.",prudnicki,23315,11599,11454,5243,6211
opolskie,161101,"Izbicko, gm.",strzelecki,4402,1720,1704,385,1319
opolskie,161102,"Jemielnica, gm.",strzelecki,5968,1970,1947,646,1301
opolskie,161103,"Kolonowskie, gm.",strzelecki,5173,1817,1786,529,1257
opolskie,161104,"Leśnica, gm.",strzelecki,6842,2724,2675,958,1717
opolskie,161105,"Strzelce Opolskie, gm.",strzelecki,27451,11963,11832,3060,8772
opolskie,161106,"Ujazd, gm.",strzelecki,5057,2005,1963,656,1307
opolskie,161107,"Zawadzkie, gm.",strzelecki,10143,3692,3642,1448,2194
opolskie,166101,"Opole, m.",Opole,97130,56741,56039,14704,41335
podkarpackie,180103,"Czarna, gm.",bieszczadzki,2023,994,982,505,477
podkarpackie,180105,"Lutowiska, gm.",bieszczadzki,2161,1233,1225,477,748
podkarpackie,180108,"Ustrzyki Dolne, gm.",bieszczadzki,14466,6868,6812,3389,3423
podkarpackie,180201,"Brzozów, gm.",brzozowski,21103,11255,11157,8076,3081
podkarpackie,180202,"Domaradz, gm.",brzozowski,4794,2636,2617,2159,458
podkarpackie,180203,"Dydnia, gm.",brzozowski,6563,3265,3228,2526,702
podkarpackie,180204,"Haczów, gm.",brzozowski,7358,3993,3965,2952,1013
podkarpackie,180205,"Jasienica Rosielna, gm.",brzozowski,5775,3849,3828,3289,539
podkarpackie,180206,"Nozdrzec, gm.",brzozowski,6916,3608,3576,2390,1186
podkarpackie,180301,"Dębica, m.",dębicki,38692,23423,23147,13055,10092
podkarpackie,180302,"Brzostek, gm.",dębicki,10212,5515,5468,4330,1138
podkarpackie,180303,"Czarna, gm.",dębicki,9935,5800,5751,4298,1453
podkarpackie,180304,"Dębica, gm.",dębicki,18894,10835,10750,7828,2922
podkarpackie,180305,"Jodłowa, gm.",dębicki,4378,2197,2168,1753,415
podkarpackie,180306,"Pilzno, gm.",dębicki,13697,8262,8176,6472,1704
podkarpackie,180307,"Żyraków, gm.",dębicki,10610,6154,6114,4711,1403
podkarpackie,180401,"Jarosław, m.",jarosławski,32082,18163,17983,10201,7782
podkarpackie,180402,"Radymno, m.",jarosławski,4425,2450,2420,1550,870
podkarpackie,180403,"Chłopice, gm.",jarosławski,4522,2305,2279,1724,555
podkarpackie,180404,"Jarosław, gm.",jarosławski,10171,5364,5326,3817,1509
podkarpackie,180405,"Laszki, gm.",jarosławski,5497,2850,2820,1987,833
podkarpackie,180406,"Pawłosiów, gm.",jarosławski,6603,3731,3701,2632,1069
podkarpackie,180407,"Pruchnik, gm.",jarosławski,7531,4338,4305,3571,734
podkarpackie,180408,"Radymno, gm.",jarosławski,8869,4565,4532,3363,1169
podkarpackie,180409,"Rokietnica, gm.",jarosławski,3469,1711,1698,1346,352
podkarpackie,180410,"Roźwienica, gm.",jarosławski,4929,2677,2642,2013,629
podkarpackie,180411,"Wiązownica, gm.",jarosławski,8948,5392,5346,4016,1330
podkarpackie,180501,"Jasło, m.",jasielski,30403,17066,16804,9483,7321
podkarpackie,180502,"Brzyska, gm.",jasielski,4994,2721,2687,2249,438
podkarpackie,180503,"Dębowiec, gm.",jasielski,6683,3817,3792,3026,766
podkarpackie,180504,"Jasło, gm.",jasielski,13090,7536,7432,5371,2061
podkarpackie,180505,"Kołaczyce, gm.",jasielski,7007,3949,3920,3031,889
podkarpackie,180506,"Krempna, gm.",jasielski,1711,851,838,506,332
podkarpackie,180507,"Nowy Żmigród, gm.",jasielski,7504,4128,4098,3187,911
podkarpackie,180508,"Osiek Jasielski, gm.",jasielski,4219,2327,2265,1845,420
podkarpackie,180509,"Skołyszyn, gm.",jasielski,9869,5092,5021,3449,1572
podkarpackie,180511,"Tarnowiec, gm.",jasielski,7301,3718,3636,2679,957
podkarpackie,180601,"Cmolas, gm.",kolbuszowski,6120,3402,3373,2739,634
podkarpackie,180602,"Kolbuszowa, gm.",kolbuszowski,19861,10726,10589,7185,3404
podkarpackie,180603,"Majdan Królewski, gm.",kolbuszowski,7648,4137,4101,3347,754
podkarpackie,180604,"Niwiska, gm.",kolbuszowski,4571,2474,2455,1909,546
podkarpackie,180605,"Raniżów, gm.",kolbuszowski,5586,3090,3065,2416,649
podkarpackie,180606,"Dzikowiec, gm.",kolbuszowski,5088,2348,2325,1851,474
podkarpackie,180701,"Chorkówka, gm.",krośnieński,10476,5708,5677,4024,1653
podkarpackie,180702,"Dukla, gm.",krośnieński,11828,5979,5913,3874,2039
podkarpackie,180703,"Iwonicz-Zdrój, gm.",krośnieński,8945,5333,5283,3565,1718
podkarpackie,180704,"Jedlicze, gm.",krośnieński,12327,6283,6205,3859,2346
podkarpackie,180705,"Korczyna, gm.",krośnieński,8747,4773,4737,3315,1422
podkarpackie,180706,"Krościenko Wyżne, gm.",krośnieński,4084,2322,2301,1607,694
podkarpackie,180707,"Miejsce Piastowe, gm.",krośnieński,10699,6143,6078,3949,2129
podkarpackie,180708,"Rymanów, gm.",krośnieński,13268,7774,7711,5119,2592
podkarpackie,180709,"Wojaszówka, gm.",krośnieński,7339,3572,3529,2306,1223
podkarpackie,180710,"Jaśliska, gm.",krośnieński,1654,789,784,580,204
podkarpackie,180801,"Leżajsk, m.",leżajski,12088,6748,6670,4153,2517
podkarpackie,180802,"Grodzisko Dolne, gm.",leżajski,6449,3779,3754,3020,734
podkarpackie,180803,"Kuryłówka, gm.",leżajski,4572,2459,2435,1761,674
podkarpackie,180804,"Leżajsk, gm.",leżajski,15390,8517,8443,6793,1650
podkarpackie,180805,"Nowa Sarzyna, gm.",leżajski,16834,9731,9646,7914,1732
podkarpackie,180901,"Lubaczów, m.",lubaczowski,10407,5600,5536,2809,2727
podkarpackie,180902,"Cieszanów, gm.",lubaczowski,6080,3029,2989,1932,1057
podkarpackie,180903,"Horyniec-Zdrój, gm.",lubaczowski,4260,2107,2082,1136,946
podkarpackie,180904,"Lubaczów, gm.",lubaczowski,7240,3378,3335,2377,958
podkarpackie,180905,"Narol, gm.",lubaczowski,6824,3378,3337,2323,1014
podkarpackie,180906,"Oleszyce, gm.",lubaczowski,5276,2734,2694,1753,941
podkarpackie,180907,"Stary Dzików, gm.",lubaczowski,3684,1880,1861,1389,472
podkarpackie,180908,"Wielkie Oczy, gm.",lubaczowski,3079,1589,1576,1118,458
podkarpackie,181001,"Łańcut, m.",łańcucki,14780,8941,8865,5365,3500
podkarpackie,181002,"Białobrzegi, gm.",łańcucki,6360,3605,3578,2709,869
podkarpackie,181003,"Czarna, gm.",łańcucki,8567,5245,5197,4090,1107
podkarpackie,181004,"Łańcut, gm.",łańcucki,16173,10034,9960,7559,2401
podkarpackie,181005,"Markowa, gm.",łańcucki,5174,2953,2930,2300,630
podkarpackie,181006,"Rakszawa, gm.",łańcucki,5572,3319,3296,2646,650
podkarpackie,181007,"Żołynia, gm.",łańcucki,5306,3132,3102,2298,804
podkarpackie,181101,"Mielec, m.",mielecki,50227,29035,28762,16027,12735
podkarpackie,181102,"Borowa, gm.",mielecki,4404,2517,2492,1708,784
podkarpackie,181103,"Czermin, gm.",mielecki,5287,2781,2758,2097,661
podkarpackie,181104,"Gawłuszowice, gm.",mielecki,2225,1302,1293,1011,282
podkarpackie,181105,"Mielec, gm.",mielecki,9829,5472,5411,3847,1564
podkarpackie,181106,"Padew Narodowa, gm.",mielecki,4306,2513,2481,2037,444
podkarpackie,181107,"Przecław, gm.",mielecki,8629,4739,4706,3709,997
podkarpackie,181108,"Radomyśl Wielki, gm.",mielecki,10597,5595,5552,4311,1241
podkarpackie,181109,"Tuszów Narodowy, gm.",mielecki,5987,3664,3628,2955,673
podkarpackie,181110,"Wadowice Górne, gm.",mielecki,5568,3039,3018,2468,550
podkarpackie,181201,"Harasiuki, gm.",niżański,5014,2435,2408,1876,532
podkarpackie,181202,"Jarocin, gm.",niżański,4366,1930,1901,1384,517
podkarpackie,181203,"Jeżowe, gm.",niżański,7571,4576,4567,4113,454
podkarpackie,181204,"Krzeszów, gm.",niżański,3480,1726,1713,1334,379
podkarpackie,181205,"Nisko, gm.",niżański,18218,9213,9098,5885,3213
podkarpackie,181206,"Rudnik nad Sanem, gm.",niżański,8252,3971,3928,2518,1410
podkarpackie,181207,"Ulanów, gm.",niżański,6955,3357,3333,2450,883
podkarpackie,181301,"Bircza, gm.",przemyski,5388,2777,2756,1948,808
podkarpackie,181302,"Dubiecko, gm.",przemyski,7672,3610,3573,2403,1170
podkarpackie,181303,"Fredropol, gm.",przemyski,4420,2128,2102,1221,881
podkarpackie,181304,"Krasiczyn, gm.",przemyski,3771,1948,1934,1081,853
podkarpackie,181305,"Krzywcza, gm.",przemyski,3936,1953,1928,1456,472
podkarpackie,181306,"Medyka, gm.",przemyski,5087,2778,2755,1766,989
podkarpackie,181307,"Orły, gm.",przemyski,6650,3535,3506,2392,1114
podkarpackie,181308,"Przemyśl, gm.",przemyski,7556,4036,3996,2331,1665
podkarpackie,181309,"Stubno, gm.",przemyski,3155,1394,1385,780,605
podkarpackie,181310,"Żurawica, gm.",przemyski,10099,5552,5480,3479,2001
podkarpackie,181401,"Przeworsk, m.",przeworski,13082,7629,7532,4657,2875
podkarpackie,181402,"Adamówka, gm.",przeworski,3320,1582,1568,1067,501
podkarpackie,181403,"Gać, gm.",przeworski,3629,1911,1889,1353,536
podkarpackie,181404,"Jawornik Polski, gm.",przeworski,3904,2031,2013,1403,610
podkarpackie,181405,"Kańczuga, gm.",przeworski,10139,4814,4767,3116,1651
podkarpackie,181406,"Przeworsk, gm.",przeworski,11479,6722,6668,5390,1278
podkarpackie,181407,"Sieniawa, gm.",przeworski,5532,2955,2927,1862,1065
podkarpackie,181408,"Tryńcza, gm.",przeworski,6408,3486,3463,2814,649
podkarpackie,181409,"Zarzecze, gm.",przeworski,5645,3151,3106,2289,817
podkarpackie,181501,"Iwierzyce, gm.",ropczycko-sędziszowski,5809,3515,3470,2831,639
podkarpackie,181502,"Ostrów, gm.",ropczycko-sędziszowski,5396,2838,2808,2231,577
podkarpackie,181503,"Ropczyce, gm.",ropczycko-sędziszowski,20584,12254,12082,9135,2947
podkarpackie,181504,"Sędziszów Małopolski, gm.",ropczycko-sędziszowski,18217,11369,11274,8858,2416
podkarpackie,181505,"Wielopole Skrzyńskie, gm.",ropczycko-sędziszowski,6505,3534,3507,2857,650
podkarpackie,181601,"Dynów, m.",rzeszowski,5022,2940,2918,2016,902
podkarpackie,181602,"Błażowa, gm.",rzeszowski,8500,4925,4885,3785,1100
podkarpackie,181603,"Boguchwała, gm.",rzeszowski,14567,9080,9014,6365,2649
podkarpackie,181604,"Chmielnik, gm.",rzeszowski,5026,2961,2937,2203,734
podkarpackie,181605,"Dynów, gm.",rzeszowski,5707,2832,2813,2157,656
podkarpackie,181606,"Głogów Małopolski, gm.",rzeszowski,14075,8536,8458,5869,2589
podkarpackie,181607,"Hyżne, gm.",rzeszowski,5346,3334,3318,2668,650
podkarpackie,181608,"Kamień, gm.",rzeszowski,5385,3021,2990,2527,463
podkarpackie,181609,"Krasne, gm.",rzeszowski,7790,4974,4930,3272,1658
podkarpackie,181610,"Lubenia, gm.",rzeszowski,5186,3113,3086,2352,734
podkarpackie,181611,"Sokołów Małopolski, gm.",rzeszowski,12948,7620,7555,6059,1496
podkarpackie,181612,"Świlcza, gm.",rzeszowski,12253,7317,7246,5054,2192
podkarpackie,181613,"Trzebownisko, gm.",rzeszowski,14998,9259,9160,6358,2802
podkarpackie,181614,"Tyczyn, gm.",rzeszowski,8356,5059,5007,3683,1324
podkarpackie,181701,"Sanok, m.",sanocki,32103,17289,17116,8319,8797
podkarpackie,181702,"Besko, gm.",sanocki,3386,1570,1558,1155,403
podkarpackie,181703,"Bukowsko, gm.",sanocki,4195,2194,2162,1363,799
podkarpackie,181704,"Komańcza, gm.",sanocki,4983,2182,2159,712,1447
podkarpackie,181705,"Sanok, gm.",sanocki,13550,6984,6921,4961,1960
podkarpackie,181706,"Tyrawa Wołoska, gm.",sanocki,1517,717,712,446,266
podkarpackie,181707,"Zagórz, gm.",sanocki,10310,5194,5167,3217,1950
podkarpackie,181708,"Zarszyn, gm.",sanocki,7343,3623,3561,2041,1520
podkarpackie,181801,"Stalowa Wola, m.",stalowowolski,52153,28584,28230,15602,12628
podkarpackie,181802,"Bojanów, gm.",stalowowolski,5627,2891,2853,2344,509
podkarpackie,181803,"Pysznica, gm.",stalowowolski,7758,3879,3845,2807,1038
podkarpackie,181804,"Radomyśl nad Sanem, gm.",stalowowolski,5899,2932,2905,2030,875
podkarpackie,181805,"Zaklików, gm.",stalowowolski,7075,3530,3503,2250,1253
podkarpackie,181806,"Zaleszany, gm.",stalowowolski,8623,4405,4353,2986,1367
podkarpackie,181901,"Czudec, gm.",strzyżowski,9140,5433,5391,4069,1322
podkarpackie,181902,"Frysztak, gm.",strzyżowski,8250,4236,4189,3052,1137
podkarpackie,181903,"Niebylec, gm.",strzyżowski,8502,5109,5068,3922,1146
podkarpackie,181904,"Strzyżów, gm.",strzyżowski,16791,8684,8608,5820,2788
podkarpackie,181905,"Wiśniowa, gm.",strzyżowski,6639,3637,3607,2801,806
podkarpackie,182001,"Baranów Sandomierski, gm.",tarnobrzeski,9664,5271,5190,3754,1436
podkarpackie,182002,"Gorzyce, gm.",tarnobrzeski,10770,4970,4893,2988,1905
podkarpackie,182003,"Grębów, gm.",tarnobrzeski,7640,3721,3691,2706,985
podkarpackie,182004,"Nowa Dęba, gm.",tarnobrzeski,15504,7987,7934,4924,3010
podkarpackie,182101,"Baligród, gm.",leski,2775,1507,1497,876,621
podkarpackie,182102,"Cisna, gm.",leski,2124,1439,1416,515,901
podkarpackie,182103,"Lesko, gm.",leski,9653,4908,4865,2806,2059
podkarpackie,182104,"Olszanica, gm.",leski,4756,2431,2397,1259,1138
podkarpackie,182105,"Solina, gm.",leski,6200,4159,4136,2168,1968
podkarpackie,186101,"Krosno, m.",Krosno,38661,22182,21929,11023,10906
podkarpackie,186201,"Przemyśl, m.",Przemyśl,52678,29994,29637,14034,15603
podkarpackie,186301,"Rzeszów, m.",Rzeszów,139183,86889,85942,42021,43921
podkarpackie,186401,"Tarnobrzeg, m.",Tarnobrzeg,38998,21907,21626,9986,11640
podlaskie,200101,"Augustów, m.",augustowski,25413,14874,14700,6895,7805
podlaskie,200102,"Augustów, gm.",augustowski,5298,2498,2470,1508,962
podlaskie,200103,"Bargłów Kościelny, gm.",augustowski,4590,1915,1905,1149,756
podlaskie,200104,"Lipsk, gm.",augustowski,4647,2123,2083,1162,921
podlaskie,200105,"Nowinka, gm.",augustowski,2718,1676,1658,792,866
podlaskie,200106,"Płaska, gm.",augustowski,2748,1687,1675,689,986
podlaskie,200107,"Sztabin, gm.",augustowski,4477,2016,2001,1129,872
podlaskie,200201,"Choroszcz, gm.",białostocki,11487,6153,6079,3525,2554
podlaskie,200202,"Czarna Białostocka, gm.",białostocki,9234,4718,4678,2376,2302
podlaskie,200203,"Dobrzyniewo Duże, gm.",białostocki,6549,3496,3464,1992,1472
podlaskie,200204,"Gródek, gm.",białostocki,4862,2314,2291,363,1928
podlaskie,200205,"Juchnowiec Kościelny, gm.",białostocki,10788,6328,6250,3516,2734
podlaskie,200206,"Łapy, gm.",białostocki,18426,10894,10784,7610,3174
podlaskie,200207,"Michałowo, gm.",białostocki,6190,2897,2862,814,2048
podlaskie,200208,"Poświętne, gm.",białostocki,2916,1724,1708,1431,277
podlaskie,200209,"Supraśl, gm.",białostocki,10455,6282,6218,2363,3855
podlaskie,200210,"Suraż, gm.",białostocki,1669,1024,1016,758,258
podlaskie,200211,"Turośń Kościelna, gm.",białostocki,4296,2585,2561,1620,941
podlaskie,200212,"Tykocin, gm.",białostocki,5362,2912,2887,2219,668
podlaskie,200213,"Wasilków, gm.",białostocki,10593,5992,5925,2906,3019
podlaskie,200214,"Zabłudów, gm.",białostocki,7074,3649,3603,1853,1750
podlaskie,200215,"Zawady, gm.",białostocki,2406,1310,1304,1104,200
podlaskie,200301,"Bielsk Podlaski, m.",bielski,21489,12468,12353,3714,8639
podlaskie,200302,"Brańsk, m.",bielski,3107,2013,1990,1517,473
podlaskie,200303,"Bielsk Podlaski, gm.",bielski,6199,2929,2898,910,1988
podlaskie,200304,"Boćki, gm.",bielski,3994,2016,1997,1234,763
podlaskie,200305,"Brańsk, gm.",bielski,5160,3683,3651,3236,415
podlaskie,200306,"Orla, gm.",bielski,2808,1381,1364,114,1250
podlaskie,200307,"Rudka, gm.",bielski,1630,934,922,681,241
podlaskie,200308,"Wyszki, gm.",bielski,3979,2327,2299,1850,449
podlaskie,200401,"Grajewo, m.",grajewski,17809,8927,8846,4887,3959
podlaskie,200402,"Grajewo, gm.",grajewski,4660,2049,2024,1391,633
podlaskie,200403,"Radziłów, gm.",grajewski,4224,2110,2096,1717,379
podlaskie,200404,"Rajgród, gm.",grajewski,4837,2354,2308,1171,1137
podlaskie,200405,"Szczuczyn, gm.",grajewski,5222,2486,2458,1683,775
podlaskie,200406,"Wąsosz, gm.",grajewski,3112,1425,1418,1079,339
podlaskie,200501,"Hajnówka, m.",hajnowski,18866,10426,10305,1890,8415
podlaskie,200502,"Białowieża, gm.",hajnowski,2193,1225,1211,232,979
podlaskie,200503,"Czeremcha, gm.",hajnowski,3041,1567,1547,247,1300
podlaskie,200504,"Czyże, gm.",hajnowski,2133,1050,1045,73,972
podlaskie,200505,"Dubicze Cerkiewne, gm.",hajnowski,1673,792,777,81,696
podlaskie,200506,"Hajnówka, gm.",hajnowski,3544,1873,1849,163,1686
podlaskie,200507,"Kleszczele, gm.",hajnowski,2484,1224,1215,211,1004
podlaskie,200508,"Narew, gm.",hajnowski,3424,1498,1480,287,1193
podlaskie,200509,"Narewka, gm.",hajnowski,3539,1692,1671,203,1468
podlaskie,200601,"Kolno, m.",kolneński,8814,4258,4211,2523,1688
podlaskie,200602,"Grabowo, gm.",kolneński,2924,1468,1454,1122,332
podlaskie,200603,"Kolno, gm.",kolneński,6868,3358,3323,2552,771
podlaskie,200604,"Mały Płock, gm.",kolneński,4027,1925,1911,1501,410
podlaskie,200605,"Stawiski, gm.",kolneński,5210,2442,2419,1842,577
podlaskie,200606,"Turośl, gm.",kolneński,3972,1926,1906,1336,570
podlaskie,200701,"Jedwabne, gm.",łomżyński,4584,2514,2493,2145,348
podlaskie,200702,"Łomża, gm.",łomżyński,8093,4614,4573,3326,1247
podlaskie,200703,"Miastkowo, gm.",łomżyński,3343,1713,1701,1411,290
podlaskie,200704,"Nowogród, gm.",łomżyński,3257,1786,1770,1254,516
podlaskie,200705,"Piątnica, gm.",łomżyński,8266,3954,3905,2875,1030
podlaskie,200706,"Przytuły, gm.",łomżyński,1798,931,923,830,93
podlaskie,200707,"Śniadowo, gm.",łomżyński,4500,2680,2647,2110,537
podlaskie,200708,"Wizna, gm.",łomżyński,3566,1907,1890,1546,344
podlaskie,200709,"Zbójna, gm.",łomżyński,3616,1705,1691,1153,538
podlaskie,200801,"Goniądz, gm.",moniecki,4297,2015,1991,1208,783
podlaskie,200802,"Jasionówka, gm.",moniecki,2433,1128,1113,766,347
podlaskie,200803,"Jaświły, gm.",moniecki,4486,1947,1921,1370,551
podlaskie,200804,"Knyszyn, gm.",moniecki,3992,1877,1851,1170,681
podlaskie,200805,"Krypno, gm.",moniecki,3293,1522,1499,1032,467
podlaskie,200806,"Mońki, gm.",moniecki,12658,5947,5857,3246,2611
podlaskie,200807,"Trzcianne, gm.",moniecki,3831,1580,1569,1160,409
podlaskie,200901,"Sejny, m.",sejneński,4788,2686,2639,921,1718
podlaskie,200902,"Giby, gm.",sejneński,2749,1639,1617,675,942
podlaskie,200903,"Krasnopol, gm.",sejneński,3477,1910,1887,735,1152
podlaskie,200904,"Puńsk, gm.",sejneński,3640,1808,1800,408,1392
podlaskie,200905,"Sejny, gm.",sejneński,3594,1661,1646,670,976
podlaskie,201001,"Siemiatycze, m.",siemiatycki,12306,6740,6675,2747,3928
podlaskie,201002,"Drohiczyn, gm.",siemiatycki,5467,2904,2881,2016,865
podlaskie,201003,"Dziadkowice, gm.",siemiatycki,2473,1207,1200,909,291
podlaskie,201004,"Grodzisk, gm.",siemiatycki,3765,2038,2022,1359,663
podlaskie,201005,"Mielnik, gm.",siemiatycki,2399,1345,1323,442,881
podlaskie,201006,"Milejczyce, gm.",siemiatycki,1852,958,954,244,710
podlaskie,201007,"Nurzec-Stacja, gm.",siemiatycki,3808,1609,1588,438,1150
podlaskie,201008,"Perlejewo, gm.",siemiatycki,2537,1264,1261,1011,250
podlaskie,201009,"Siemiatycze, gm.",siemiatycki,5234,2537,2509,1110,1399
podlaskie,201101,"Dąbrowa Białostocka, gm.",sokólski,10349,5138,5099,3083,2016
podlaskie,201102,"Janów, gm.",sokólski,3631,1640,1620,1022,598
podlaskie,201103,"Korycin, gm.",sokólski,2767,1185,1177,803,374
podlaskie,201104,"Krynki, gm.",sokólski,2810,1423,1404,690,714
podlaskie,201105,"Kuźnica, gm.",sokólski,3518,1782,1772,1234,538
podlaskie,201106,"Nowy Dwór, gm.",sokólski,2474,1128,1123,585,538
podlaskie,201107,"Sidra, gm.",sokólski,3129,1377,1355,811,544
podlaskie,201108,"Sokółka, gm.",sokólski,21460,10711,10604,5362,5242
podlaskie,201109,"Suchowola, gm.",sokólski,6055,2837,2804,1717,1087
podlaskie,201110,"Szudziałowo, gm.",sokólski,2837,1216,1196,566,630
podlaskie,201201,"Bakałarzewo, gm.",suwalski,2559,1206,1196,559,637
podlaskie,201202,"Filipów, gm.",suwalski,3768,1738,1711,1022,689
podlaskie,201203,"Jeleniewo, gm.",suwalski,2579,1412,1398,787,611
podlaskie,201204,"Przerośl, gm.",suwalski,2394,1183,1174,757,417
podlaskie,201205,"Raczki, gm.",suwalski,4804,2479,2457,1521,936
podlaskie,201206,"Rutka-Tartak, gm.",suwalski,2061,1076,1065,596,469
podlaskie,201207,"Suwałki, gm.",suwalski,5718,3008,2977,1422,1555
podlaskie,201208,"Szypliszki, gm.",suwalski,3242,1538,1529,726,803
podlaskie,201209,"Wiżajny, gm.",suwalski,2107,1135,1122,590,532
podlaskie,201301,"Wysokie Mazowieckie, m.",wysokomazowiecki,7733,4612,4572,2742,1830
podlaskie,201302,"Ciechanowiec, gm.",wysokomazowiecki,7672,4055,4006,2839,1167
podlaskie,201303,"Czyżew-Osada, gm.",wysokomazowiecki,5327,3196,3166,2413,753
podlaskie,201304,"Klukowo, gm.",wysokomazowiecki,3769,2367,2351,2113,238
podlaskie,201305,"Kobylin-Borzymy, gm.",wysokomazowiecki,2866,1729,1721,1589,132
podlaskie,201306,"Kulesze Kościelne, gm.",wysokomazowiecki,2656,1842,1827,1662,165
podlaskie,201307,"Nowe Piekuty, gm.",wysokomazowiecki,3271,2138,2121,1848,273
podlaskie,201308,"Sokoły, gm.",wysokomazowiecki,4905,2957,2927,2490,437
podlaskie,201309,"Szepietowo, gm.",wysokomazowiecki,5825,3498,3441,2648,793
podlaskie,201310,"Wysokie Mazowieckie, gm.",wysokomazowiecki,4258,2518,2506,2073,433
podlaskie,201401,"Zambrów, m.",zambrowski,18180,9399,9269,5429,3840
podlaskie,201402,"Kołaki Kościelne, gm.",zambrowski,1941,1260,1247,1098,149
podlaskie,201403,"Rutki, gm.",zambrowski,4964,2694,2657,2046,611
podlaskie,201404,"Szumowo, gm.",zambrowski,3952,2251,2223,1821,402
podlaskie,201405,"Zambrów, gm.",zambrowski,7657,4260,4227,3132,1095
podlaskie,206101,"Białystok, m.",Białystok,226907,136659,135046,57084,77962
podlaskie,206201,"Łomża, m.",Łomża,49147,27224,26905,14943,11962
podlaskie,206301,"Suwałki, m.",Suwałki,53836,29564,29249,12536,16713
pomorskie,220101,"Borzytuchom, gm.",bytowski,2195,969,956,333,623
pomorskie,220102,"Bytów, gm.",bytowski,18906,10161,10040,3755,6285
pomorskie,220103,"Czarna Dąbrówka, gm.",bytowski,4632,2290,2265,965,1300
pomorskie,220104,"Kołczygłowy, gm.",bytowski,3252,1371,1348,468,880
pomorskie,220105,"Lipnica, gm.",bytowski,4210,2427,2386,1244,1142
pomorskie,220106,"Miastko, gm.",bytowski,15902,7109,7052,2139,4913
pomorskie,220107,"Parchowo, gm.",bytowski,2739,1641,1622,750,872
pomorskie,220108,"Studzienice, gm.",bytowski,2964,1676,1666,616,1050
pomorskie,220109,"Trzebielino, gm.",bytowski,2921,1241,1230,362,868
pomorskie,220110,"Tuchomie, gm.",bytowski,3098,1418,1407,581,826
pomorskie,220201,"Chojnice, m.",chojnicki,31727,18199,18013,6250,11763
pomorskie,220202,"Brusy, gm.",chojnicki,10455,6364,6321,3460,2861
pomorskie,220203,"Chojnice, gm.",chojnicki,13480,7045,6974,2691,4283
pomorskie,220204,"Czersk, gm.",chojnicki,16377,8500,8424,4175,4249
pomorskie,220205,"Konarzyny, gm.",chojnicki,1738,950,933,403,530
pomorskie,220301,"Człuchów, m.",człuchowski,11932,6615,6544,1777,4767
pomorskie,220302,"Czarne, gm.",człuchowski,8712,4467,4399,1114,3285
pomorskie,220303,"Człuchów, gm.",człuchowski,7840,3270,3226,1174,2052
pomorskie,220304,"Debrzno, gm.",człuchowski,7258,3167,3135,956,2179
pomorskie,220305,"Koczała, gm.",człuchowski,2991,1434,1417,340,1077
pomorskie,220306,"Przechlewo, gm.",człuchowski,5053,2604,2575,622,1953
pomorskie,220307,"Rzeczenica, gm.",człuchowski,2996,1360,1346,450,896
pomorskie,220401,"Pruszcz Gdański, m.",gdański,20335,12587,12442,3876,8566
pomorskie,220402,"Cedry Wielkie, gm.",gdański,4918,2185,2156,849,1307
pomorskie,220403,"Kolbudy, gm.",gdański,10232,6155,6103,1862,4241
pomorskie,220404,"Pruszcz Gdański, gm.",gdański,14780,8671,8575,2976,5599
pomorskie,220405,"Przywidz, gm.",gdański,4255,2207,2195,848,1347
pomorskie,220406,"Pszczółki, gm.",gdański,6279,3298,3266,1270,1996
pomorskie,220407,"Suchy Dąb, gm.",gdański,3077,1340,1317,458,859
pomorskie,220408,"Trąbki Wielkie, gm.",gdański,7517,3396,3335,1424,1911
pomorskie,220501,"Chmielno, gm.",kartuski,5415,3169,3138,1649,1489
pomorskie,220502,"Kartuzy, gm.",kartuski,24156,14662,14500,6934,7566
pomorskie,220503,"Przodkowo, gm.",kartuski,5428,3159,3136,1823,1313
pomorskie,220504,"Sierakowice, gm.",kartuski,12739,7967,7893,5051,2842
pomorskie,220505,"Somonino, gm.",kartuski,7097,3796,3763,1904,1859
pomorskie,220506,"Stężyca, gm.",kartuski,7482,4688,4603,2481,2122
pomorskie,220507,"Sulęczyno, gm.",kartuski,4546,3041,2998,1482,1516
pomorskie,220508,"Żukowo, gm.",kartuski,20629,12511,12371,4731,7640
pomorskie,220601,"Kościerzyna, m.",kościerski,18577,10506,10405,4204,6201
pomorskie,220602,"Dziemiany, gm.",kościerski,3540,2231,2211,1181,1030
pomorskie,220603,"Karsin, gm.",kościerski,5115,3236,3193,1428,1765
pomorskie,220604,"Kościerzyna, gm.",kościerski,11525,6746,6689,3149,3540
pomorskie,220605,"Liniewo, gm.",kościerski,3674,1949,1932,938,994
pomorskie,220606,"Lipusz, gm.",kościerski,2744,1679,1656,905,751
pomorskie,220607,"Nowa Karczma, gm.",kościerski,4843,2533,2509,1189,1320
pomorskie,220608,"Stara Kiszewa, gm.",kościerski,5406,2831,2804,1371,1433
pomorskie,220701,"Kwidzyn, m.",kwidzyński,29997,16013,15861,5077,10784
pomorskie,220702,"Gardeja, gm.",kwidzyński,6392,2264,2235,993,1242
pomorskie,220703,"Kwidzyn, gm.",kwidzyński,8178,3442,3388,1272,2116
pomorskie,220704,"Prabuty, gm.",kwidzyński,10557,4689,4641,1972,2669
pomorskie,220705,"Ryjewo, gm.",kwidzyński,4361,1706,1683,524,1159
pomorskie,220706,"Sadlinki, gm.",kwidzyński,4320,1775,1759,815,944
pomorskie,220801,"Lębork, m.",lęborski,27664,15281,15135,5090,10045
pomorskie,220802,"Łeba, m.",lęborski,7835,6345,6173,2099,4074
pomorskie,220803,"Cewice, gm.",lęborski,5309,2623,2588,1049,1539
pomorskie,220804,"Nowa Wieś Lęborska, gm.",lęborski,9828,4866,4797,1912,2885
pomorskie,220805,"Wicko, gm.",lęborski,4660,1998,1978,621,1357
pomorskie,220901,"Malbork, m.",malborski,30827,16603,16414,5264,11150
pomorskie,220903,"Lichnowy, gm.",malborski,3559,1484,1442,561,881
pomorskie,220904,"Malbork, gm.",malborski,3350,1403,1383,501,882
pomorskie,220906,"Miłoradz, gm.",malborski,2663,1162,1145,476,669
pomorskie,220907,"Nowy Staw, gm.",malborski,6083,2495,2459,817,1642
pomorskie,220908,"Stare Pole, gm.",malborski,3618,1563,1542,505,1037
pomorskie,221001,"Krynica Morska, m.",nowodworski,4108,3535,3506,1072,2434
pomorskie,221002,"Nowy Dwór Gdański, gm.",nowodworski,14072,6412,6326,2090,4236
pomorskie,221003,"Ostaszewo, gm.",nowodworski,2479,1135,1124,487,637
pomorskie,221004,"Stegna, gm.",nowodworski,11081,6633,6569,2344,4225
pomorskie,221005,"Sztutowo, gm.",nowodworski,4180,2654,2620,854,1766
pomorskie,221101,"Hel, m.",pucki,4408,3017,2990,915,2075
pomorskie,221102,"Jastarnia, m.",pucki,8928,7642,7594,2482,5112
pomorskie,221103,"Puck, m.",pucki,9529,5773,5714,1545,4169
pomorskie,221104,"Władysławowo, m.",pucki,27294,22391,22249,7356,14893
pomorskie,221105,"Kosakowo, gm.",pucki,9165,6471,6404,1701,4703
pomorskie,221106,"Krokowa, gm.",pucki,11350,7628,7555,2780,4775
pomorskie,221107,"Puck, gm.",pucki,17674,9477,9384,3857,5527
pomorskie,221201,"Ustka, m.",słupski,17922,11532,11420,3694,7726
pomorskie,221202,"Damnica, gm.",słupski,4756,1819,1798,646,1152
pomorskie,221203,"Dębnica Kaszubska, gm.",słupski,7411,3052,3018,962,2056
pomorskie,221204,"Główczyce, gm.",słupski,7410,2765,2721,820,1901
pomorskie,221205,"Kępice, gm.",słupski,7317,3214,3191,919,2272
pomorskie,221206,"Kobylnica, gm.",słupski,8049,3407,3367,1106,2261
pomorskie,221207,"Potęgowo, gm.",słupski,5526,2206,2190,646,1544
pomorskie,221208,"Słupsk, gm.",słupski,11377,4950,4898,1373,3525
pomorskie,221209,"Smołdzino, gm.",słupski,3022,1500,1478,532,946
pomorskie,221210,"Ustka, gm.",słupski,9496,6377,6322,2192,4130
pomorskie,221301,"Czarna Woda, m.",starogardzki,2659,1433,1418,711,707
pomorskie,221302,"Skórcz, m.",starogardzki,2697,1467,1452,752,700
pomorskie,221303,"Starogard Gdański, m.",starogardzki,37823,20116,19893,8675,11218
pomorskie,221304,"Bobowo, gm.",starogardzki,2241,1063,1052,704,348
pomorskie,221305,"Kaliska, gm.",starogardzki,4054,2031,2015,857,1158
pomorskie,221306,"Lubichowo, gm.",starogardzki,5088,2723,2674,1244,1430
pomorskie,221307,"Osieczna, gm.",starogardzki,2310,1243,1229,631,598
pomorskie,221308,"Osiek, gm.",starogardzki,2383,1485,1471,576,895
pomorskie,221309,"Skarszewy, gm.",starogardzki,10715,5205,5156,2387,2769
pomorskie,221310,"Skórcz, gm.",starogardzki,3476,1655,1640,1098,542
pomorskie,221311,"Smętowo Graniczne, gm.",starogardzki,4196,1890,1872,835,1037
pomorskie,221312,"Starogard Gdański, gm.",starogardzki,10587,5732,5682,2843,2839
pomorskie,221313,"Zblewo, gm.",starogardzki,8492,4280,4226,2203,2023
pomorskie,221401,"Tczew, m.",tczewski,46584,26458,26154,9814,16340
pomorskie,221402,"Gniew, gm.",tczewski,12357,5567,5517,2237,3280
pomorskie,221403,"Morzeszczyn, gm.",tczewski,2835,1197,1179,554,625
pomorskie,221404,"Pelplin, gm.",tczewski,12725,5757,5690,2444,3246
pomorskie,221405,"Subkowy, gm.",tczewski,3965,1853,1823,829,994
pomorskie,221406,"Tczew, gm.",tczewski,9135,4653,4583,1908,2675
pomorskie,221501,"Reda, m.",wejherowski,15638,9470,9343,3038,6305
pomorskie,221502,"Rumia, m.",wejherowski,35906,22369,22080,7496,14584
pomorskie,221503,"Wejherowo, m.",wejherowski,37544,22114,21889,7915,13974
pomorskie,221504,"Choczewo, gm.",wejherowski,5840,3391,3367,1075,2292
pomorskie,221505,"Gniewino, gm.",wejherowski,5312,2666,2628,875,1753
pomorskie,221506,"Linia, gm.",wejherowski,4422,2549,2522,1467,1055
pomorskie,221507,"Luzino, gm.",wejherowski,9694,5347,5298,2967,2331
pomorskie,221508,"Łęczyce, gm.",wejherowski,8507,4016,3979,1777,2202
pomorskie,221509,"Szemud, gm.",wejherowski,10588,6123,6049,2977,3072
pomorskie,221510,"Wejherowo, gm.",wejherowski,14707,8010,7922,3456,4466
pomorskie,221601,"Dzierzgoń, gm.",sztumski,7521,3236,3188,1215,1973
pomorskie,221602,"Mikołajki Pomorskie, gm.",sztumski,2835,954,947,470,477
pomorskie,221603,"Stary Dzierzgoń, gm.",sztumski,3344,1087,1073,370,703
pomorskie,221604,"Stary Targ, gm.",sztumski,4966,1870,1847,710,1137
pomorskie,221605,"Sztum, gm.",sztumski,15492,7647,7551,2252,5299
pomorskie,226101,"Gdańsk, m.",Gdańsk,363888,235588,232715,74937,157778
pomorskie,226201,"Gdynia, m.",Gdynia,206079,138412,136498,39087,97411
pomorskie,226301,"Słupsk, m.",Słupsk,76061,42644,42143,13284,28859
pomorskie,226401,"Sopot, m.",Sopot,37250,27076,26761,7413,19348
pomorskie,229901,Statki - Gdańsk,Statki - Gdańsk,253,251,246,89,157
śląskie,240101,"Będzin, m.",będziński,47043,25157,24770,8332,16438
śląskie,240102,"Czeladź, m.",będziński,27469,14890,14662,4994,9668
śląskie,240103,"Wojkowice, m.",będziński,8788,4834,4751,1302,3449
śląskie,240104,"Bobrowniki, gm.",będziński,9341,5164,5088,1846,3242
śląskie,240105,"Mierzęcice, gm.",będziński,6064,3159,3110,1285,1825
śląskie,240106,"Psary, gm.",będziński,9442,4986,4919,1762,3157
śląskie,240107,"Siewierz, gm.",będziński,10126,5173,5117,2434,2683
śląskie,240108,"Sławków, m.",będziński,5631,3189,3133,1386,1747
śląskie,240201,"Szczyrk, m.",bielski,5126,3319,3281,1554,1727
śląskie,240202,"Bestwina, gm.",bielski,8534,5281,5230,2327,2903
śląskie,240203,"Buczkowice, gm.",bielski,8597,5290,5238,2603,2635
śląskie,240204,"Czechowice-Dziedzice, gm.",bielski,34197,20429,20212,8567,11645
śląskie,240205,"Jasienica, gm.",bielski,16995,10485,10377,4611,5766
śląskie,240206,"Jaworze, gm.",bielski,5380,3340,3311,921,2390
śląskie,240207,"Kozy, gm.",bielski,9504,5887,5827,2682,3145
śląskie,240208,"Porąbka, gm.",bielski,12098,7307,7202,3780,3422
śląskie,240209,"Wilamowice, gm.",bielski,12377,7503,7421,4187,3234
śląskie,240210,"Wilkowice, gm.",bielski,10898,6727,6672,2677,3995
śląskie,240301,"Cieszyn, m.",cieszyński,29200,17547,17310,5221,12089
śląskie,240302,"Ustroń, m.",cieszyński,15287,9686,9581,2822,6759
śląskie,240303,"Wisła, m.",cieszyński,10389,6673,6612,995,5617
śląskie,240304,"Brenna, gm.",cieszyński,9297,5480,5432,2373,3059
śląskie,240305,"Chybie, gm.",cieszyński,7286,3967,3934,2047,1887
śląskie,240306,"Dębowiec, gm.",cieszyński,4321,2539,2498,868,1630
śląskie,240307,"Goleszów, gm.",cieszyński,10141,6124,6057,1243,4814
śląskie,240308,"Hażlach, gm.",cieszyński,7818,4383,4330,1801,2529
śląskie,240309,"Istebna, gm.",cieszyński,9275,5585,5551,3425,2126
śląskie,240310,"Skoczów, gm.",cieszyński,20493,11466,11318,4377,6941
śląskie,240311,"Strumień, gm.",cieszyński,9683,5605,5549,2768,2781
śląskie,240312,"Zebrzydowice, gm.",cieszyński,9913,5778,5708,2768,2940
śląskie,240401,"Blachownia, gm.",częstochowski,10873,5719,5644,2067,3577
śląskie,240402,"Dąbrowa Zielona, gm.",częstochowski,3444,1544,1528,850,678
śląskie,240403,"Janów, gm.",częstochowski,4936,2497,2457,1385,1072
śląskie,240404,"Kamienica Polska, gm.",częstochowski,4542,2285,2260,824,1436
śląskie,240405,"Kłomnice, gm.",częstochowski,11186,5664,5598,3272,2326
śląskie,240406,"Koniecpol, gm.",częstochowski,8479,4115,4075,2574,1501
śląskie,240407,"Konopiska, gm.",częstochowski,8567,4267,4212,1607,2605
śląskie,240408,"Kruszyna, gm.",częstochowski,3926,1925,1906,1221,685
śląskie,240409,"Lelów, gm.",częstochowski,4289,2191,2162,1395,767
śląskie,240410,"Mstów, gm.",częstochowski,8234,4297,4257,2542,1715
śląskie,240411,"Mykanów, gm.",częstochowski,11200,6136,6058,3571,2487
śląskie,240412,"Olsztyn, gm.",częstochowski,6153,3338,3284,1533,1751
śląskie,240413,"Poczesna, gm.",częstochowski,10246,5384,5319,2260,3059
śląskie,240414,"Przyrów, gm.",częstochowski,3290,1452,1433,823,610
śląskie,240415,"Rędziny, gm.",częstochowski,7931,4287,4217,2155,2062
śląskie,240416,"Starcza, gm.",częstochowski,2284,1117,1105,563,542
śląskie,240501,"Knurów, m.",gliwicki,30498,16179,16006,7642,8364
śląskie,240502,"Pyskowice, m.",gliwicki,14779,6956,6887,2438,4449
śląskie,240503,"Gierałtowice, gm.",gliwicki,8667,5057,4999,2589,2410
śląskie,240504,"Pilchowice, gm.",gliwicki,8693,4222,4176,1802,2374
śląskie,240505,"Rudziniec, gm.",gliwicki,8599,3583,3529,1334,2195
śląskie,240506,"Sośnicowice, gm.",gliwicki,6746,3085,3056,1035,2021
śląskie,240507,"Toszek, gm.",gliwicki,8146,3272,3235,1284,1951
śląskie,240508,"Wielowieś, gm.",gliwicki,4782,1732,1709,754,955
śląskie,240601,"Kłobuck, gm.",kłobucki,16661,9067,8942,4035,4907
śląskie,240602,"Krzepice, gm.",kłobucki,7746,3894,3853,2096,1757
śląskie,240603,"Lipie, gm.",kłobucki,5312,2713,2679,1575,1104
śląskie,240604,"Miedźno, gm.",kłobucki,6139,3361,3318,2221,1097
śląskie,240605,"Opatów, gm.",kłobucki,5479,2373,2348,1325,1023
śląskie,240606,"Panki, gm.",kłobucki,4087,1875,1856,891,965
śląskie,240607,"Popów, gm.",kłobucki,5073,2383,2348,1291,1057
śląskie,240608,"Przystajń, gm.",kłobucki,4925,2174,2149,1017,1132
śląskie,240609,"Wręczyca Wielka, gm.",kłobucki,13935,6657,6555,3226,3329
śląskie,240701,"Lubliniec, m.",lubliniecki,19122,10540,10383,4102,6281
śląskie,240702,"Boronów, gm.",lubliniecki,2693,1326,1314,669,645
śląskie,240703,"Ciasna, gm.",lubliniecki,6867,2636,2605,1000,1605
śląskie,240704,"Herby, gm.",lubliniecki,6059,3146,3088,1080,2008
śląskie,240705,"Kochanowice, gm.",lubliniecki,5415,2401,2378,1283,1095
śląskie,240706,"Koszęcin, gm.",lubliniecki,9478,5087,5037,2649,2388
śląskie,240707,"Pawonków, gm.",lubliniecki,5259,2227,2199,1039,1160
śląskie,240708,"Woźniki, gm.",lubliniecki,7720,3995,3958,2206,1752
śląskie,240801,"Łaziska Górne, m.",mikołowski,17157,9374,9267,4230,5037
śląskie,240802,"Mikołów, m.",mikołowski,31137,18205,18022,7059,10963
śląskie,240803,"Orzesze, m.",mikołowski,15177,8417,8339,4450,3889
śląskie,240804,"Ornontowice, gm.",mikołowski,4330,2467,2443,1415,1028
śląskie,240805,"Wyry, gm.",mikołowski,5346,3121,3082,1504,1578
śląskie,240901,"Myszków, m.",myszkowski,26712,13852,13658,5961,7697
śląskie,240902,"Koziegłowy, gm.",myszkowski,11895,5654,5605,3176,2429
śląskie,240903,"Niegowa, gm.",myszkowski,4620,2423,2397,1810,587
śląskie,240904,"Poraj, gm.",myszkowski,9197,4947,4883,1817,3066
śląskie,240905,"Żarki, gm.",myszkowski,6946,3477,3438,1915,1523
śląskie,241001,"Goczałkowice-Zdrój, gm.",pszczyński,5258,3125,3083,1403,1680
śląskie,241002,"Kobiór, gm.",pszczyński,3736,2256,2229,1277,952
śląskie,241003,"Miedźna, gm.",pszczyński,12117,7022,6930,4629,2301
śląskie,241004,"Pawłowice, gm.",pszczyński,13544,7929,7830,5005,2825
śląskie,241005,"Pszczyna, gm.",pszczyński,39585,23637,23438,11621,11817
śląskie,241006,"Suszec, gm.",pszczyński,8514,5001,4946,3158,1788
śląskie,241101,"Racibórz, m.",raciborski,45632,22739,22506,7790,14716
śląskie,241102,"Kornowac, gm.",raciborski,3854,2049,2027,1143,884
śląskie,241103,"Krzanowice, gm.",raciborski,4858,1716,1705,516,1189
śląskie,241104,"Krzyżanowice, gm.",raciborski,9349,3538,3506,1101,2405
śląskie,241105,"Kuźnia Raciborska, gm.",raciborski,9745,3855,3813,1242,2571
śląskie,241106,"Nędza, gm.",raciborski,5893,2482,2438,971,1467
śląskie,241107,"Pietrowice Wielkie, gm.",raciborski,5740,2153,2133,695,1438
śląskie,241108,"Rudnik, gm.",raciborski,4267,1581,1567,647,920
śląskie,241201,"Czerwionka-Leszczyny, gm.",rybnicki,32566,16964,16810,9112,7698
śląskie,241202,"Gaszowice, gm.",rybnicki,7126,3699,3657,1856,1801
śląskie,241203,"Jejkowice, gm.",rybnicki,3012,1701,1681,997,684
śląskie,241204,"Lyski, gm.",rybnicki,7494,4072,4024,1932,2092
śląskie,241205,"Świerklany, gm.",rybnicki,8902,5239,5180,3237,1943
śląskie,241301,"Kalety, m.",tarnogórski,7227,3593,3561,1701,1860
śląskie,241302,"Miasteczko Śląskie, m.",tarnogórski,5836,2955,2921,1430,1491
śląskie,241303,"Radzionków, m.",tarnogórski,13547,7687,7614,3653,3961
śląskie,241304,"Tarnowskie Góry, m.",tarnogórski,49927,27362,27053,10332,16721
śląskie,241305,"Krupski Młyn, gm.",tarnogórski,2691,1423,1409,669,740
śląskie,241306,"Ożarowice, gm.",tarnogórski,4445,2459,2424,1242,1182
śląskie,241307,"Świerklaniec, gm.",tarnogórski,9128,4806,4743,2124,2619
śląskie,241308,"Tworóg, gm.",tarnogórski,6430,2961,2935,1320,1615
śląskie,241309,"Zbrosławice, gm.",tarnogórski,12491,5162,5105,1893,3212
śląskie,241401,"Bieruń, m.",bieruńsko-lędziński,15589,8477,8393,4721,3672
śląskie,241402,"Imielin, m.",bieruńsko-lędziński,6428,3800,3751,1984,1767
śląskie,241403,"Lędziny, m.",bieruńsko-lędziński,12641,6909,6823,4150,2673
śląskie,241404,"Bojszowy, gm.",bieruńsko-lędziński,5509,3426,3401,2283,1118
śląskie,241405,"Chełm Śląski, gm.",bieruńsko-lędziński,4603,2663,2643,1571,1072
śląskie,241501,"Pszów, m.",wodzisławski,11430,5838,5780,3236,2544
śląskie,241502,"Radlin, m.",wodzisławski,14035,7283,7200,3411,3789
śląskie,241503,"Rydułtowy, m.",wodzisławski,17598,9032,8958,4206,4752
śląskie,241504,"Wodzisław Śląski, m.",wodzisławski,39003,21533,21300,10061,11239
śląskie,241505,"Godów, gm.",wodzisławski,10288,5863,5806,3317,2489
śląskie,241506,"Gorzyce, gm.",wodzisławski,16006,8471,8378,4440,3938
śląskie,241507,"Lubomia, gm.",wodzisławski,6497,3103,3082,1759,1323
śląskie,241508,"Marklowice, gm.",wodzisławski,4111,2375,2352,1419,933
śląskie,241509,"Mszana, gm.",wodzisławski,5674,3275,3245,2310,935
śląskie,241601,"Poręba, m.",zawierciański,7295,3924,3859,1478,2381
śląskie,241602,"Zawiercie, m.",zawierciański,43259,23273,22969,9398,13571
śląskie,241603,"Irządze, gm.",zawierciański,2378,1162,1144,790,354
śląskie,241604,"Kroczyce, gm.",zawierciański,5315,2688,2661,1440,1221
śląskie,241605,"Łazy, gm.",zawierciański,13253,6927,6825,2971,3854
śląskie,241606,"Ogrodzieniec, gm.",zawierciański,7975,4185,4157,1911,2246
śląskie,241607,"Pilica, gm.",zawierciański,7520,3945,3898,2612,1286
śląskie,241608,"Szczekociny, gm.",zawierciański,7089,3866,3818,2357,1461
śląskie,241609,"Włodowice, gm.",zawierciański,4415,2185,2171,1054,1117
śląskie,241610,"Żarnowiec, gm.",zawierciański,3945,2118,2086,1600,486
śląskie,241701,"Żywiec, m.",żywiecki,26226,15691,15532,6586,8946
śląskie,241702,"Czernichów, gm.",żywiecki,5719,3750,3721,2116,1605
śląskie,241703,"Gilowice, gm.",żywiecki,4742,2880,2861,1738,1123
śląskie,241704,"Jeleśnia, gm.",żywiecki,10941,6470,6430,3917,2513
śląskie,241705,"Koszarawa, gm.",żywiecki,2068,1194,1182,792,390
śląskie,241706,"Lipowa, gm.",żywiecki,7822,4504,4453,2142,2311
śląskie,241707,"Łękawica, gm.",żywiecki,3461,2021,2007,1243,764
śląskie,241708,"Łodygowice, gm.",żywiecki,10844,6542,6470,3451,3019
śląskie,241709,"Milówka, gm.",żywiecki,8225,4655,4604,3067,1537
śląskie,241710,"Radziechowy-Wieprz, gm.",żywiecki,10039,5808,5744,3795,1949
śląskie,241711,"Rajcza, gm.",żywiecki,7803,4138,4103,2360,1743
śląskie,241712,"Ślemień, gm.",żywiecki,2822,1752,1726,1157,569
śląskie,241713,"Świnna, gm.",żywiecki,6387,3782,3742,2024,1718
śląskie,241714,"Ujsoły, gm.",żywiecki,4001,2134,2108,1187,921
śląskie,241715,"Węgierska Górka, gm.",żywiecki,11987,7114,7035,4227,2808
śląskie,246101,"Bielsko-Biała, m.",Bielsko-Biała,138943,86511,85607,33355,52252
śląskie,246201,"Bytom, m.",Bytom,136128,66005,65181,25382,39799
śląskie,246301,"Chorzów, m.",Chorzów,86997,44177,43609,14264,29345
śląskie,246401,"Częstochowa, m.",Częstochowa,192652,111486,110109,43968,66141
śląskie,246501,"Dąbrowa Górnicza, m.",Dąbrowa Górnicza,102140,54759,53992,19330,34662
śląskie,246601,"Gliwice, m.",Gliwice,148054,83759,82781,27541,55240
śląskie,246701,"Jastrzębie-Zdrój, m.",Jastrzębie-Zdrój,72590,40490,40100,22305,17795
śląskie,246801,"Jaworzno, m.",Jaworzno,75734,41224,40761,16658,24103
śląskie,246901,"Katowice, m.",Katowice,246478,141683,139885,50691,89194
śląskie,247001,"Mysłowice, m.",Mysłowice,58916,32781,32385,15109,17276
śląskie,247101,"Piekary Śląskie, m.",Piekary Śląskie,46604,24634,24353,11543,12810
śląskie,247201,"Ruda Śląska, m.",Ruda Śląska,112635,58132,57400,27541,29859
śląskie,247301,"Rybnik, m.",Rybnik,110713,60478,59831,27340,32491
śląskie,247401,"Siemianowice Śląskie, m.",Siemianowice Śląskie,55783,29312,28919,9880,19039
śląskie,247501,"Sosnowiec, m.",Sosnowiec,177308,95598,94236,34175,60061
śląskie,247601,"Świętochłowice, m.",Świętochłowice,42004,19352,19098,7325,11773
śląskie,247701,"Tychy, m.",Tychy,103366,60465,59788,24359,35429
śląskie,247801,"Zabrze, m.",Zabrze,143997,64704,63860,23700,40160
śląskie,247901,"Żory, m.",Żory,47958,26062,25762,11912,13850
świętokrzyskie,260101,"Busko-Zdrój, gm.",buski,28647,15547,15406,8211,7195
świętokrzyskie,260102,"Gnojno, gm.",buski,3809,1722,1686,1307,379
świętokrzyskie,260103,"Nowy Korczyn, gm.",buski,5302,2621,2591,1726,865
świętokrzyskie,260104,"Pacanów, gm.",buski,6544,2958,2933,1961,972
świętokrzyskie,260105,"Solec-Zdrój, gm.",buski,4376,2195,2163,1351,812
świętokrzyskie,260106,"Stopnica, gm.",buski,6530,3108,3071,2155,916
świętokrzyskie,260107,"Tuczępy, gm.",buski,3089,1576,1562,1214,348
świętokrzyskie,260108,"Wiślica, gm.",buski,4926,2138,2117,1462,655
świętokrzyskie,260201,"Imielno, gm.",jędrzejowski,3689,1699,1689,1258,431
świętokrzyskie,260202,"Jędrzejów, gm.",jędrzejowski,23909,12523,12369,7270,5099
świętokrzyskie,260203,"Małogoszcz, gm.",jędrzejowski,9331,5237,5198,3883,1315
świętokrzyskie,260204,"Nagłowice, gm.",jędrzejowski,4252,2004,1986,1425,561
świętokrzyskie,260205,"Oksa, gm.",jędrzejowski,4011,2058,2040,1440,600
świętokrzyskie,260206,"Sędziszów, gm.",jędrzejowski,10791,5124,5072,3289,1783
świętokrzyskie,260207,"Słupia (Jędrzejowska), gm.",jędrzejowski,3636,1623,1607,1168,439
świętokrzyskie,260208,"Sobków, gm.",jędrzejowski,6762,3385,3340,2422,918
świętokrzyskie,260209,"Wodzisław, gm.",jędrzejowski,6421,3094,3053,2110,943
świętokrzyskie,260301,"Bejsce, gm.",kazimierski,3572,1454,1442,965,477
świętokrzyskie,260302,"Czarnocin, gm.",kazimierski,3463,1516,1496,1056,440
świętokrzyskie,260303,"Kazimierza Wielka, gm.",kazimierski,14061,6068,5999,3782,2217
świętokrzyskie,260304,"Opatowiec, gm.",kazimierski,3222,1379,1341,839,502
świętokrzyskie,260305,"Skalbmierz, gm.",kazimierski,5637,2309,2285,1634,651
świętokrzyskie,260401,"Bieliny, gm.",kielecki,7735,3903,3855,3053,802
świętokrzyskie,260402,"Bodzentyn, gm.",kielecki,9487,4696,4647,3317,1330
świętokrzyskie,260403,"Chęciny, gm.",kielecki,12308,6582,6493,4124,2369
świętokrzyskie,260404,"Chmielnik, gm.",kielecki,9169,4901,4834,3421,1413
świętokrzyskie,260405,"Daleszyce, gm.",kielecki,11793,6373,6297,4448,1849
świętokrzyskie,260406,"Górno, gm.",kielecki,10199,6087,6013,4665,1348
świętokrzyskie,260407,"Łagów, gm.",kielecki,5475,2764,2728,2151,577
świętokrzyskie,260408,"Łopuszno, gm.",kielecki,7127,4070,4032,3183,849
świętokrzyskie,260409,"Masłów, gm.",kielecki,7862,4534,4467,2754,1713
świętokrzyskie,260410,"Miedziana Góra, gm.",kielecki,8267,4595,4537,2678,1859
świętokrzyskie,260411,"Mniów, gm.",kielecki,7305,3921,3889,3150,739
świętokrzyskie,260412,"Morawica, gm.",kielecki,11118,5999,5945,3670,2275
świętokrzyskie,260413,"Nowa Słupia, gm.",kielecki,8276,3784,3758,2612,1146
świętokrzyskie,260414,"Piekoszów, gm.",kielecki,12131,6649,6589,4733,1856
świętokrzyskie,260415,"Pierzchnica, gm.",kielecki,3861,1995,1959,1458,501
świętokrzyskie,260416,"Raków, gm.",kielecki,5105,2494,2471,1740,731
świętokrzyskie,260417,"Sitkówka-Nowiny, gm.",kielecki,5559,3229,3186,1751,1435
świętokrzyskie,260418,"Strawczyn, gm.",kielecki,7665,4321,4276,3263,1013
świętokrzyskie,260419,"Zagnańsk, gm.",kielecki,10402,6092,6021,3659,2362
świętokrzyskie,260501,"Fałków, gm.",konecki,4107,2050,2025,1512,513
świętokrzyskie,260502,"Gowarczów, gm.",konecki,3862,1842,1812,1282,530
świętokrzyskie,260503,"Końskie, gm.",konecki,30704,17376,17124,9502,7622
świętokrzyskie,260504,"Radoszyce, gm.",konecki,7524,3990,3948,3193,755
świętokrzyskie,260505,"Ruda Maleniecka, gm.",konecki,2906,1716,1691,1176,515
świętokrzyskie,260506,"Słupia (Konecka), gm.",konecki,2883,1596,1578,1196,382
świętokrzyskie,260507,"Smyków, gm.",konecki,2990,1740,1714,1303,411
świętokrzyskie,260508,"Stąporków, gm.",konecki,15240,7247,7167,4036,3131
świętokrzyskie,260601,"Baćkowice, gm.",opatowski,4193,2110,2094,1738,356
świętokrzyskie,260602,"Iwaniska, gm.",opatowski,5665,2903,2862,2305,557
świętokrzyskie,260603,"Lipnik, gm.",opatowski,4663,2125,2109,1514,595
świętokrzyskie,260604,"Opatów, gm.",opatowski,10264,5183,5086,3155,1931
świętokrzyskie,260605,"Ożarów, gm.",opatowski,9083,3894,3846,2258,1588
świętokrzyskie,260606,"Sadowie, gm.",opatowski,3497,1564,1549,1132,417
świętokrzyskie,260607,"Tarłów, gm.",opatowski,4634,1988,1950,1432,518
świętokrzyskie,260608,"Wojciechowice, gm.",opatowski,3582,1569,1535,1007,528
świętokrzyskie,260701,"Ostrowiec Świętokrzyski, m.",ostrowiecki,60698,30770,30412,14521,15891
świętokrzyskie,260702,"Bałtów, gm.",ostrowiecki,3205,1556,1547,898,649
świętokrzyskie,260703,"Bodzechów, gm.",ostrowiecki,11214,5406,5323,2998,2325
świętokrzyskie,260704,"Ćmielów, gm.",ostrowiecki,6440,2755,2729,1603,1126
świętokrzyskie,260705,"Kunów, gm.",ostrowiecki,8187,3906,3858,2242,1616
świętokrzyskie,260706,"Waśniów, gm.",ostrowiecki,5682,2538,2509,2031,478
świętokrzyskie,260801,"Działoszyce, gm.",pińczowski,4660,1895,1874,1143,731
świętokrzyskie,260802,"Kije, gm.",pińczowski,3758,1899,1881,1358,523
świętokrzyskie,260803,"Michałów, gm.",pińczowski,3958,1782,1766,1288,478
świętokrzyskie,260804,"Pińczów, gm.",pińczowski,18638,9123,9032,4774,4258
świętokrzyskie,260805,"Złota, gm.",pińczowski,4063,1728,1710,1092,618
świętokrzyskie,260901,"Sandomierz, m.",sandomierski,20552,10910,10778,4781,5997
świętokrzyskie,260902,"Dwikozy, gm.",sandomierski,7538,3078,3032,1750,1282
świętokrzyskie,260903,"Klimontów, gm.",sandomierski,6985,3311,3270,2325,945
świętokrzyskie,260904,"Koprzywnica, gm.",sandomierski,5659,3105,3067,2355,712
świętokrzyskie,260905,"Łoniów, gm.",sandomierski,6015,3136,3104,2418,686
świętokrzyskie,260906,"Obrazów, gm.",sandomierski,5477,2656,2614,1868,746
świętokrzyskie,260907,"Samborzec, gm.",sandomierski,7326,3764,3739,2628,1111
świętokrzyskie,260908,"Wilczyce, gm.",sandomierski,3162,1426,1415,935,480
świętokrzyskie,260909,"Zawichost, gm.",sandomierski,3902,1754,1722,1053,669
świętokrzyskie,261001,"Skarżysko-Kamienna, m.",skarżyski,40519,22530,22260,10949,11311
świętokrzyskie,261002,"Bliżyn, gm.",skarżyski,7070,3524,3482,2052,1430
świętokrzyskie,261003,"Łączna, gm.",skarżyski,4235,2172,2145,1537,608
świętokrzyskie,261004,"Skarżysko Kościelne, gm.",skarżyski,5131,2771,2735,1668,1067
świętokrzyskie,261005,"Suchedniów, gm.",skarżyski,8883,4871,4795,2458,2337
świętokrzyskie,261101,"Starachowice, m.",starachowicki,43833,23735,23456,10900,12556
świętokrzyskie,261102,"Brody, gm.",starachowicki,8818,4510,4446,2948,1498
świętokrzyskie,261103,"Mirzec, gm.",starachowicki,6722,3618,3593,2591,1002
świętokrzyskie,261104,"Pawłów, gm.",starachowicki,11985,5995,5945,4945,1000
świętokrzyskie,261105,"Wąchock, gm.",starachowicki,5883,3156,3121,1854,1267
świętokrzyskie,261201,"Bogoria, gm.",staszowski,6399,3045,3026,2290,736
świętokrzyskie,261202,"Łubnice, gm.",staszowski,3553,1924,1894,1505,389
świętokrzyskie,261203,"Oleśnica, gm.",staszowski,3254,1551,1538,1122,416
świętokrzyskie,261204,"Osiek, gm.",staszowski,6300,3405,3384,2910,474
świętokrzyskie,261205,"Połaniec, gm.",staszowski,9667,5359,5298,3713,1585
świętokrzyskie,261206,"Rytwiany, gm.",staszowski,5134,2507,2487,1764,723
świętokrzyskie,261207,"Staszów, gm.",staszowski,22032,11006,10923,6371,4552
świętokrzyskie,261208,"Szydłów, gm.",staszowski,4107,2005,1979,1393,586
świętokrzyskie,261301,"Kluczewsko, gm.",włoszczowski,4275,2326,2295,1733,562
świętokrzyskie,261302,"Krasocin, gm.",włoszczowski,8615,4640,4595,3263,1332
świętokrzyskie,261303,"Moskorzew, gm.",włoszczowski,2466,1275,1260,931,329
świętokrzyskie,261304,"Radków, gm.",włoszczowski,2250,1077,1065,653,412
świętokrzyskie,261305,"Secemin, gm.",włoszczowski,4237,1947,1933,1311,622
świętokrzyskie,261306,"Włoszczowa, gm.",włoszczowski,16590,9076,8964,6046,2918
świętokrzyskie,266101,"Kielce, m.",Kielce,164561,101046,99730,44876,54854
warmińsko-mazurskie,280101,"Bartoszyce, m.",bartoszycki,20395,10624,10502,3844,6658
warmińsko-mazurskie,280102,"Górowo Iławeckie, m.",bartoszycki,3614,1732,1707,470,1237
warmińsko-mazurskie,280103,"Bartoszyce, gm.",bartoszycki,8543,3404,3366,1548,1818
warmińsko-mazurskie,280104,"Bisztynek, gm.",bartoszycki,5530,1986,1967,705,1262
warmińsko-mazurskie,280105,"Górowo Iławeckie, gm.",bartoszycki,7005,2503,2476,686,1790
warmińsko-mazurskie,280106,"Sępopol, gm.",bartoszycki,5456,2067,2049,850,1199
warmińsko-mazurskie,280201,"Braniewo, m.",braniewski,14021,7137,7048,2477,4571
warmińsko-mazurskie,280202,"Braniewo, gm.",braniewski,4922,1790,1772,712,1060
warmińsko-mazurskie,280203,"Frombork, gm.",braniewski,3296,1592,1568,512,1056
warmińsko-mazurskie,280204,"Lelkowo, gm.",braniewski,2567,918,899,343,556
warmińsko-mazurskie,280205,"Pieniężno, gm.",braniewski,5604,2175,2158,905,1253
warmińsko-mazurskie,280206,"Płoskinia, gm.",braniewski,2064,817,807,331,476
warmińsko-mazurskie,280207,"Wilczęta, gm.",braniewski,2522,792,787,326,461
warmińsko-mazurskie,280301,"Działdowo, m.",działdowski,17409,9260,9147,3680,5467
warmińsko-mazurskie,280302,"Działdowo, gm.",działdowski,7410,2959,2921,1437,1484
warmińsko-mazurskie,280303,"Iłowo-Osada, gm.",działdowski,5647,2659,2638,1457,1181
warmińsko-mazurskie,280304,"Lidzbark, gm.",działdowski,11750,5598,5547,2908,2639
warmińsko-mazurskie,280305,"Płośnica, gm.",działdowski,4685,2087,2067,1103,964
warmińsko-mazurskie,280306,"Rybno, gm.",działdowski,5767,3075,3045,1832,1213
warmińsko-mazurskie,280401,"Elbląg, gm.",elbląski,5349,2189,2156,874,1282
warmińsko-mazurskie,280402,"Godkowo, gm.",elbląski,2705,981,974,472,502
warmińsko-mazurskie,280403,"Gronowo Elbląskie, gm.",elbląski,3861,1537,1498,536,962
warmińsko-mazurskie,280404,"Markusy, gm.",elbląski,3096,1201,1179,529,650
warmińsko-mazurskie,280405,"Milejewo, gm.",elbląski,2419,1062,1045,535,510
warmińsko-mazurskie,280406,"Młynary, gm.",elbląski,3568,1606,1582,695,887
warmińsko-mazurskie,280407,"Pasłęk, gm.",elbląski,15577,6903,6848,2512,4336
warmińsko-mazurskie,280408,"Rychliki, gm.",elbląski,3287,1212,1194,397,797
warmińsko-mazurskie,280409,"Tolkmicko, gm.",elbląski,5301,2336,2302,799,1503
warmińsko-mazurskie,280501,"Ełk, m.",ełcki,45252,23235,22937,9401,13536
warmińsko-mazurskie,280502,"Ełk, gm.",ełcki,8226,3456,3412,1287,2125
warmińsko-mazurskie,280503,"Kalinowo, gm.",ełcki,5462,2110,2086,920,1166
warmińsko-mazurskie,280504,"Prostki, gm.",ełcki,5956,2161,2129,955,1174
warmińsko-mazurskie,280505,"Stare Juchy, gm.",ełcki,3378,1355,1348,509,839
warmińsko-mazurskie,280601,"Giżycko, m.",giżycki,25228,14566,14393,4344,10049
warmińsko-mazurskie,280604,"Giżycko, gm.",giżycki,6915,3494,3431,1072,2359
warmińsko-mazurskie,280605,"Kruklanki, gm.",giżycki,2737,1349,1307,391,916
warmińsko-mazurskie,280606,"Miłki, gm.",giżycki,3497,1637,1622,541,1081
warmińsko-mazurskie,280608,"Ryn, gm.",giżycki,5425,2701,2669,816,1853
warmińsko-mazurskie,280610,"Wydminy, gm.",giżycki,5541,2534,2494,941,1553
warmińsko-mazurskie,280701,"Iława, m.",iławski,28516,15538,15377,5435,9942
warmińsko-mazurskie,280702,"Lubawa, m.",iławski,7436,4105,4059,1774,2285
warmińsko-mazurskie,280703,"Iława, gm.",iławski,9707,4370,4324,1854,2470
warmińsko-mazurskie,280704,"Kisielice, gm.",iławski,4865,1900,1872,951,921
warmińsko-mazurskie,280705,"Lubawa, gm.",iławski,7894,3977,3938,2474,1464
warmińsko-mazurskie,280706,"Susz, gm.",iławski,9967,3935,3903,1637,2266
warmińsko-mazurskie,280707,"Zalewo, gm.",iławski,5885,2309,2283,826,1457
warmińsko-mazurskie,280801,"Kętrzyn, m.",kętrzyński,23271,11810,11686,4014,7672
warmińsko-mazurskie,280802,"Barciany, gm.",kętrzyński,5451,1806,1779,618,1161
warmińsko-mazurskie,280803,"Kętrzyn, gm.",kętrzyński,6530,2517,2479,894,1585
warmińsko-mazurskie,280804,"Korsze, gm.",kętrzyński,8760,3218,3159,1218,1941
warmińsko-mazurskie,280805,"Reszel, gm.",kętrzyński,7028,3205,3169,1105,2064
warmińsko-mazurskie,280806,"Srokowo, gm.",kętrzyński,3424,1458,1435,418,1017
warmińsko-mazurskie,280901,"Lidzbark Warmiński, m.",lidzbarski,13121,7095,6972,2298,4674
warmińsko-mazurskie,280902,"Kiwity, gm.",lidzbarski,2852,1193,1178,509,669
warmińsko-mazurskie,280903,"Lidzbark Warmiński, gm.",lidzbarski,5356,1968,1948,718,1230
warmińsko-mazurskie,280904,"Lubomino, gm.",lidzbarski,2889,1184,1175,521,654
warmińsko-mazurskie,280905,"Orneta, gm.",lidzbarski,10118,4504,4443,1688,2755
warmińsko-mazurskie,281001,"Mrągowo, m.",mrągowski,18196,9997,9850,3368,6482
warmińsko-mazurskie,281002,"Mikołajki, gm.",mrągowski,8620,4987,4930,1451,3479
warmińsko-mazurskie,281003,"Mrągowo, gm.",mrągowski,6128,2566,2536,901,1635
warmińsko-mazurskie,281004,"Piecki, gm.",mrągowski,7002,3552,3513,1319,2194
warmińsko-mazurskie,281005,"Sorkwity, gm.",mrągowski,4057,1960,1943,631,1312
warmińsko-mazurskie,281101,"Janowiec Kościelny, gm.",nidzicki,2685,1218,1199,825,374
warmińsko-mazurskie,281102,"Janowo, gm.",nidzicki,2289,1019,1006,633,373
warmińsko-mazurskie,281103,"Kozłowo, gm.",nidzicki,4805,1935,1910,931,979
warmińsko-mazurskie,281104,"Nidzica, gm.",nidzicki,17344,8806,8683,3622,5061
warmińsko-mazurskie,281201,"Nowe Miasto Lubawskie, m.",nowomiejski,8766,4532,4453,1832,2621
warmińsko-mazurskie,281202,"Biskupiec, gm.",nowomiejski,7639,3415,3369,1435,1934
warmińsko-mazurskie,281203,"Grodziczno, gm.",nowomiejski,4987,2422,2395,1521,874
warmińsko-mazurskie,281204,"Kurzętnik, gm.",nowomiejski,6904,3059,3013,1674,1339
warmińsko-mazurskie,281205,"Nowe Miasto Lubawskie, gm.",nowomiejski,6106,2830,2790,1536,1254
warmińsko-mazurskie,281303,"Kowale Oleckie, gm.",olecki,4300,1560,1540,607,933
warmińsko-mazurskie,281304,"Olecko, gm.",olecki,17326,8862,8754,3357,5397
warmińsko-mazurskie,281305,"Świętajno, gm.",olecki,3307,1381,1373,496,877
warmińsko-mazurskie,281306,"Wieliczki, gm.",olecki,2702,1211,1194,562,632
warmińsko-mazurskie,281401,"Barczewo, gm.",olsztyński,13941,6823,6725,2156,4569
warmińsko-mazurskie,281402,"Biskupiec, gm.",olsztyński,15698,7149,7049,2289,4760
warmińsko-mazurskie,281403,"Dobre Miasto, gm.",olsztyński,12818,5959,5891,2314,3577
warmińsko-mazurskie,281404,"Dywity, gm.",olsztyński,7716,4203,4150,1320,2830
warmińsko-mazurskie,281405,"Gietrzwałd, gm.",olsztyński,4831,2603,2567,803,1764
warmińsko-mazurskie,281406,"Jeziorany, gm.",olsztyński,6392,2297,2266,936,1330
warmińsko-mazurskie,281407,"Jonkowo, gm.",olsztyński,4966,2563,2534,832,1702
warmińsko-mazurskie,281408,"Kolno, gm.",olsztyński,2902,1195,1177,436,741
warmińsko-mazurskie,281409,"Olsztynek, gm.",olsztyński,11694,5696,5620,1968,3652
warmińsko-mazurskie,281410,"Purda, gm.",olsztyński,6665,3142,3087,951,2136
warmińsko-mazurskie,281411,"Stawiguda, gm.",olsztyński,5345,3192,3142,803,2339
warmińsko-mazurskie,281412,"Świątki, gm.",olsztyński,3243,1272,1259,535,724
warmińsko-mazurskie,281501,"Ostróda, m.",ostródzki,27323,15413,15238,5261,9977
warmińsko-mazurskie,281502,"Dąbrówno, gm.",ostródzki,3603,1651,1628,745,883
warmińsko-mazurskie,281503,"Grunwald, gm.",ostródzki,4537,1742,1716,626,1090
warmińsko-mazurskie,281504,"Łukta, gm.",ostródzki,3635,1636,1623,464,1159
warmińsko-mazurskie,281505,"Małdyty, gm.",ostródzki,5200,1887,1868,659,1209
warmińsko-mazurskie,281506,"Miłakowo, gm.",ostródzki,4565,1640,1624,705,919
warmińsko-mazurskie,281507,"Miłomłyn, gm.",ostródzki,4283,1922,1907,694,1213
warmińsko-mazurskie,281508,"Morąg, gm.",ostródzki,20103,9571,9469,3201,6268
warmińsko-mazurskie,281509,"Ostróda, gm.",ostródzki,12198,5583,5528,2004,3524
warmińsko-mazurskie,281601,"Biała Piska, gm.",piski,9533,4150,4102,2042,2060
warmińsko-mazurskie,281602,"Orzysz, gm.",piski,8222,4055,4005,1395,2610
warmińsko-mazurskie,281603,"Pisz, gm.",piski,22663,11679,11531,5280,6251
warmińsko-mazurskie,281604,"Ruciane-Nida, gm.",piski,9124,5670,5600,2129,3471
warmińsko-mazurskie,281701,"Szczytno, m.",szczycieński,21077,11782,11614,4522,7092
warmińsko-mazurskie,281702,"Dźwierzuty, gm.",szczycieński,5645,2449,2411,971,1440
warmińsko-mazurskie,281703,"Jedwabno, gm.",szczycieński,3675,2075,2056,739,1317
warmińsko-mazurskie,281704,"Pasym, gm.",szczycieński,4706,2440,2412,831,1581
warmińsko-mazurskie,281705,"Rozogi, gm.",szczycieński,4483,2038,1998,1167,831
warmińsko-mazurskie,281706,"Szczytno, gm.",szczycieński,8782,3758,3707,1556,2151
warmińsko-mazurskie,281707,"Świętajno, gm.",szczycieński,5511,2796,2763,1169,1594
warmińsko-mazurskie,281708,"Wielbark, gm.",szczycieński,5073,2024,1998,956,1042
warmińsko-mazurskie,281801,"Banie Mazurskie, gm.",gołdapski,3332,1320,1297,421,876
warmińsko-mazurskie,281802,"Dubeninki, gm.",gołdapski,2672,1051,1037,487,550
warmińsko-mazurskie,281803,"Gołdap, gm.",gołdapski,16487,7633,7556,2486,5070
warmińsko-mazurskie,281901,"Budry, gm.",węgorzewski,2510,935,928,368,560
warmińsko-mazurskie,281902,"Pozezdrze, gm.",węgorzewski,3038,1433,1409,544,865
warmińsko-mazurskie,281903,"Węgorzewo, gm.",węgorzewski,14825,7237,7177,2192,4985
warmińsko-mazurskie,286101,"Elbląg, m.",Elbląg,96912,51579,50953,19004,31949
warmińsko-mazurskie,286201,"Olsztyn, m.",Olsztyn,134564,82341,81074,26798,54276
wielkopolskie,300101,"Chodzież, m.",chodzieski,15754,9025,8907,2405,6502
wielkopolskie,300102,"Budzyń, gm.",chodzieski,6474,2975,2954,918,2036
wielkopolskie,300103,"Chodzież, gm.",chodzieski,4333,2257,2229,612,1617
wielkopolskie,300104,"Margonin, gm.",chodzieski,4890,2654,2618,837,1781
wielkopolskie,300105,"Szamocin, gm.",chodzieski,5695,2879,2853,1057,1796
wielkopolskie,300201,"Czarnków, m.",czarnkowsko-trzcianecki,9157,5185,5123,1422,3701
wielkopolskie,300202,"Czarnków, gm.",czarnkowsko-trzcianecki,8383,4018,3961,1344,2617
wielkopolskie,300203,"Drawsko, gm.",czarnkowsko-trzcianecki,4766,2268,2237,929,1308
wielkopolskie,300204,"Krzyż Wielkopolski, gm.",czarnkowsko-trzcianecki,6885,3225,3195,1071,2124
wielkopolskie,300205,"Lubasz, gm.",czarnkowsko-trzcianecki,5471,2688,2657,979,1678
wielkopolskie,300206,"Połajewo, gm.",czarnkowsko-trzcianecki,4734,2326,2287,1024,1263
wielkopolskie,300207,"Trzcianka, gm.",czarnkowsko-trzcianecki,18772,9948,9856,3172,6684
wielkopolskie,300208,"Wieleń, gm.",czarnkowsko-trzcianecki,10211,4912,4841,1954,2887
wielkopolskie,300301,"Gniezno, m.",gnieźnieński,56189,31794,31400,10996,20404
wielkopolskie,300302,"Czerniejewo, gm.",gnieźnieński,6221,3127,3065,1328,1737
wielkopolskie,300303,"Gniezno, gm.",gnieźnieński,7178,3650,3597,1631,1966
wielkopolskie,300304,"Kiszkowo, gm.",gnieźnieński,4164,2062,2027,886,1141
wielkopolskie,300305,"Kłecko, gm.",gnieźnieński,5900,2907,2868,1508,1360
wielkopolskie,300306,"Łubowo, gm.",gnieźnieński,4401,2224,2197,962,1235
wielkopolskie,300307,"Mieleszyn, gm.",gnieźnieński,3063,1439,1429,708,721
wielkopolskie,300308,"Niechanowo, gm.",gnieźnieński,4201,2036,1996,1103,893
wielkopolskie,300309,"Trzemeszno, gm.",gnieźnieński,11193,5130,5048,2192,2856
wielkopolskie,300310,"Witkowo, gm.",gnieźnieński,10912,5637,5551,2617,2934
wielkopolskie,300401,"Borek Wielkopolski, gm.",gostyński,6068,2617,2582,1209,1373
wielkopolskie,300402,"Gostyń, gm.",gostyński,22225,11475,11342,4313,7029
wielkopolskie,300403,"Krobia, gm.",gostyński,10259,4678,4634,2312,2322
wielkopolskie,300404,"Pępowo, gm.",gostyński,4682,2325,2287,1221,1066
wielkopolskie,300405,"Piaski, gm.",gostyński,6658,3279,3227,1611,1616
wielkopolskie,300406,"Pogorzela, gm.",gostyński,3964,1705,1673,844,829
wielkopolskie,300407,"Poniec, gm.",gostyński,6223,2551,2519,1224,1295
wielkopolskie,300501,"Granowo, gm.",grodziski,3749,1900,1874,1012,862
wielkopolskie,300502,"Grodzisk Wielkopolski, gm.",grodziski,14630,7542,7447,2823,4624
wielkopolskie,300503,"Kamieniec, gm.",grodziski,5004,2370,2332,983,1349
wielkopolskie,300504,"Rakoniewice, gm.",grodziski,9600,4360,4311,1681,2630
wielkopolskie,300505,"Wielichowo, gm.",grodziski,5233,2515,2467,1195,1272
wielkopolskie,300601,"Jaraczewo, gm.",jarociński,6459,3157,3104,1683,1421
wielkopolskie,300602,"Jarocin, gm.",jarociński,35919,18298,18011,7543,10468
wielkopolskie,300603,"Kotlin, gm.",jarociński,5554,2602,2566,1414,1152
wielkopolskie,300604,"Żerków, gm.",jarociński,8259,3985,3924,2287,1637
wielkopolskie,300701,"Blizanów, gm.",kaliski,7517,3475,3410,1941,1469
wielkopolskie,300702,"Brzeziny, gm.",kaliski,4569,2087,2054,1383,671
wielkopolskie,300703,"Ceków-Kolonia, gm.",kaliski,3777,1687,1645,891,754
wielkopolskie,300704,"Godziesze Wielkie, gm.",kaliski,6922,3460,3425,2247,1178
wielkopolskie,300705,"Koźminek, gm.",kaliski,5923,2806,2779,1911,868
wielkopolskie,300706,"Lisków, gm.",kaliski,4234,2024,1978,1233,745
wielkopolskie,300707,"Mycielin, gm.",kaliski,3893,1670,1640,1088,552
wielkopolskie,300708,"Opatówek, gm.",kaliski,8291,4503,4454,2755,1699
wielkopolskie,300709,"Stawiszyn, gm.",kaliski,5805,2775,2747,1614,1133
wielkopolskie,300710,"Szczytniki, gm.",kaliski,6195,3175,3149,2359,790
wielkopolskie,300711,"Żelazków, gm.",kaliski,7246,3809,3768,2425,1343
wielkopolskie,300801,"Baranów, gm.",kępiński,5891,3228,3197,1750,1447
wielkopolskie,300802,"Bralin, gm.",kępiński,4529,2474,2458,1159,1299
wielkopolskie,300803,"Kępno, gm.",kępiński,19632,10898,10780,4407,6373
wielkopolskie,300804,"Łęka Opatowska, gm.",kępiński,4080,2094,2062,1041,1021
wielkopolskie,300805,"Perzów, gm.",kępiński,2994,1335,1319,692,627
wielkopolskie,300806,"Rychtal, gm.",kępiński,3147,1458,1429,673,756
wielkopolskie,300807,"Trzcinica, gm.",kępiński,3752,1856,1840,1030,810
wielkopolskie,300901,"Koło, m.",kolski,18833,10247,10125,5041,5084
wielkopolskie,300902,"Babiak, gm.",kolski,6458,3007,2960,2054,906
wielkopolskie,300903,"Chodów, gm.",kolski,2855,1318,1303,889,414
wielkopolskie,300904,"Dąbie, gm.",kolski,5460,2887,2868,2202,666
wielkopolskie,300905,"Grzegorzew, gm.",kolski,4436,2153,2131,1518,613
wielkopolskie,300906,"Kłodawa, gm.",kolski,10775,5263,5189,3301,1888
wielkopolskie,300907,"Koło, gm.",kolski,5752,2864,2832,1973,859
wielkopolskie,300908,"Kościelec, gm.",kolski,5161,2506,2470,1702,768
wielkopolskie,300909,"Olszówka, gm.",kolski,3755,1731,1699,1322,377
wielkopolskie,300910,"Osiek Mały, gm.",kolski,4550,2264,2230,1711,519
wielkopolskie,300911,"Przedecz, gm.",kolski,3501,1742,1727,1195,532
wielkopolskie,301001,"Golina, gm.",koniński,9218,4518,4454,2734,1720
wielkopolskie,301002,"Grodziec, gm.",koniński,4037,1847,1833,1149,684
wielkopolskie,301003,"Kazimierz Biskupi, gm.",koniński,8479,4473,4420,2789,1631
wielkopolskie,301004,"Kleczew, gm.",koniński,7845,4079,4022,2638,1384
wielkopolskie,301005,"Kramsk, gm.",koniński,8103,4164,4116,2883,1233
wielkopolskie,301006,"Krzymów, gm.",koniński,5563,3060,3008,2162,846
wielkopolskie,301007,"Rychwał, gm.",koniński,6482,3354,3313,2260,1053
wielkopolskie,301008,"Rzgów, gm.",koniński,5385,2634,2600,1800,800
wielkopolskie,301009,"Skulsk, gm.",koniński,4930,2117,2098,1349,749
wielkopolskie,301010,"Sompolno, gm.",koniński,8330,4143,4092,2861,1231
wielkopolskie,301011,"Stare Miasto, gm.",koniński,8275,4630,4578,2685,1893
wielkopolskie,301012,"Ślesin, gm.",koniński,11819,6256,6178,3727,2451
wielkopolskie,301013,"Wierzbinek, gm.",koniński,5899,2689,2663,2005,658
wielkopolskie,301014,"Wilczyn, gm.",koniński,5075,2507,2474,1570,904
wielkopolskie,301101,"Kościan, m.",kościański,19586,11201,11054,3709,7345
wielkopolskie,301102,"Czempiń, gm.",kościański,8854,4239,4151,1595,2556
wielkopolskie,301103,"Kościan, gm.",kościański,11964,5905,5788,2414,3374
wielkopolskie,301104,"Krzywiń, gm.",kościański,7848,3791,3747,1981,1766
wielkopolskie,301105,"Śmigiel, gm.",kościański,13816,6510,6404,2827,3577
wielkopolskie,301201,"Sulmierzyce, m.",krotoszyński,2197,1195,1183,546,637
wielkopolskie,301202,"Kobylin, gm.",krotoszyński,6337,2919,2867,1415,1452
wielkopolskie,301203,"Koźmin Wielkopolski, gm.",krotoszyński,10738,5350,5262,2510,2752
wielkopolskie,301204,"Krotoszyn, gm.",krotoszyński,31955,16886,16652,7683,8969
wielkopolskie,301205,"Rozdrażew, gm.",krotoszyński,3957,1976,1950,1406,544
wielkopolskie,301206,"Zduny, gm.",krotoszyński,5581,2735,2695,1198,1497
wielkopolskie,301301,"Krzemieniewo, gm.",leszczyński,6642,3028,2975,1262,1713
wielkopolskie,301302,"Lipno, gm.",leszczyński,4861,2570,2537,1104,1433
wielkopolskie,301303,"Osieczna, gm.",leszczyński,6928,3385,3355,1383,1972
wielkopolskie,301304,"Rydzyna, gm.",leszczyński,6378,3324,3285,1339,1946
wielkopolskie,301305,"Święciechowa, gm.",leszczyński,5663,2574,2548,978,1570
wielkopolskie,301306,"Wijewo, gm.",leszczyński,2934,1604,1580,562,1018
wielkopolskie,301307,"Włoszakowice, gm.",leszczyński,7219,3650,3607,1457,2150
wielkopolskie,301401,"Chrzypsko Wielkie, gm.",międzychodzki,2673,1208,1197,466,731
wielkopolskie,301402,"Kwilcz, gm.",międzychodzki,4779,2166,2115,610,1505
wielkopolskie,301403,"Międzychód, gm.",międzychodzki,14702,7578,7456,2265,5191
wielkopolskie,301404,"Sieraków, gm.",międzychodzki,7149,3441,3385,1032,2353
wielkopolskie,301501,"Kuślin, gm.",nowotomyski,4168,1925,1898,844,1054
wielkopolskie,301502,"Lwówek, gm.",nowotomyski,6988,3205,3168,1180,1988
wielkopolskie,301503,"Miedzichowo, gm.",nowotomyski,2958,1442,1422,476,946
wielkopolskie,301504,"Nowy Tomyśl, gm.",nowotomyski,19452,10705,10594,3152,7442
wielkopolskie,301505,"Opalenica, gm.",nowotomyski,12294,6589,6514,2471,4043
wielkopolskie,301506,"Zbąszyń, gm.",nowotomyski,10605,5747,5690,1836,3854
wielkopolskie,301601,"Oborniki, gm.",obornicki,25537,13859,13698,4382,9316
wielkopolskie,301602,"Rogoźno, gm.",obornicki,13509,6783,6719,2284,4435
wielkopolskie,301603,"Ryczywół, gm.",obornicki,5587,2816,2783,1145,1638
wielkopolskie,301701,"Ostrów Wielkopolski, m.",ostrowski,59499,33957,33546,12371,21175
wielkopolskie,301702,"Nowe Skalmierzyce, gm.",ostrowski,12019,5865,5789,3167,2622
wielkopolskie,301703,"Odolanów, gm.",ostrowski,11018,6057,5971,3900,2071
wielkopolskie,301704,"Ostrów Wielkopolski, gm.",ostrowski,14202,7229,7150,4096,3054
wielkopolskie,301705,"Przygodzice, gm.",ostrowski,9089,5045,4989,2717,2272
wielkopolskie,301706,"Raszków, gm.",ostrowski,8932,4415,4358,2670,1688
wielkopolskie,301707,"Sieroszewice, gm.",ostrowski,7503,3539,3504,2212,1292
wielkopolskie,301708,"Sośnie, gm.",ostrowski,5069,2421,2395,1247,1148
wielkopolskie,301801,"Czajków, gm.",ostrzeszowski,2013,957,943,596,347
wielkopolskie,301802,"Doruchów, gm.",ostrzeszowski,3978,1906,1887,1108,779
wielkopolskie,301803,"Grabów nad Prosną, gm.",ostrzeszowski,6089,2970,2916,1664,1252
wielkopolskie,301804,"Kobyla Góra, gm.",ostrzeszowski,4830,2474,2436,973,1463
wielkopolskie,301805,"Kraszewice, gm.",ostrzeszowski,2869,1306,1281,706,575
wielkopolskie,301806,"Mikstat, gm.",ostrzeszowski,5004,2332,2301,1422,879
wielkopolskie,301807,"Ostrzeszów, gm.",ostrzeszowski,18715,9621,9493,3844,5649
wielkopolskie,301901,"Piła, m.",pilski,58186,33568,33136,10124,23012
wielkopolskie,301902,"Białośliwie, gm.",pilski,3767,1904,1881,833,1048
wielkopolskie,301903,"Kaczory, gm.",pilski,5889,3261,3209,1208,2001
wielkopolskie,301904,"Łobżenica, gm.",pilski,7557,3713,3652,2035,1617
wielkopolskie,301905,"Miasteczko Krajeńskie, gm.",pilski,2519,1208,1196,515,681
wielkopolskie,301906,"Szydłowo, gm.",pilski,6176,2887,2849,866,1983
wielkopolskie,301907,"Ujście, gm.",pilski,6302,3151,3108,1012,2096
wielkopolskie,301908,"Wyrzysk, gm.",pilski,10951,5428,5367,2336,3031
wielkopolskie,301909,"Wysoka, gm.",pilski,5209,2430,2412,1026,1386
wielkopolskie,302001,"Chocz, gm.",pleszewski,3725,1731,1719,927,792
wielkopolskie,302002,"Czermin, gm.",pleszewski,3774,1857,1822,1242,580
wielkopolskie,302003,"Dobrzyca, gm.",pleszewski,6483,3079,3033,1514,1519
wielkopolskie,302004,"Gizałki, gm.",pleszewski,3568,1497,1471,933,538
wielkopolskie,302005,"Gołuchów, gm.",pleszewski,7849,3947,3887,2232,1655
wielkopolskie,302006,"Pleszew, gm.",pleszewski,23965,12172,11988,4883,7105
wielkopolskie,302101,"Luboń, m.",poznański,21756,13432,13279,3838,9441
wielkopolskie,302102,"Puszczykowo, m.",poznański,7319,5243,5189,1455,3734
wielkopolskie,302103,"Buk, gm.",poznański,9302,5191,5129,2172,2957
wielkopolskie,302104,"Czerwonak, gm.",poznański,19678,11753,11602,3174,8428
wielkopolskie,302105,"Dopiewo, gm.",poznański,12706,7903,7808,2235,5573
wielkopolskie,302106,"Kleszczewo, gm.",poznański,4273,2641,2608,982,1626
wielkopolskie,302107,"Komorniki, gm.",poznański,13699,8434,8305,2152,6153
wielkopolskie,302108,"Kostrzyn, gm.",poznański,12923,6757,6662,2478,4184
wielkopolskie,302109,"Kórnik, gm.",poznański,15116,8993,8903,2986,5917
wielkopolskie,302110,"Mosina, gm.",poznański,20816,12488,12341,4065,8276
wielkopolskie,302111,"Murowana Goślina, gm.",poznański,12672,7165,7072,1784,5288
wielkopolskie,302112,"Pobiedziska, gm.",poznański,13777,7903,7809,2429,5380
wielkopolskie,302113,"Rokietnica, gm.",poznański,8660,5331,5266,1458,3808
wielkopolskie,302114,"Stęszew, gm.",poznański,11312,5782,5708,2004,3704
wielkopolskie,302115,"Suchy Las, gm.",poznański,10459,7142,7066,1781,5285
wielkopolskie,302116,"Swarzędz, gm.",poznański,32860,19981,19716,6052,13664
wielkopolskie,302117,"Tarnowo Podgórne, gm.",poznański,15838,10012,9898,2846,7052
wielkopolskie,302201,"Bojanowo, gm.",rawicki,6870,3035,2979,1063,1916
wielkopolskie,302202,"Jutrosin, gm.",rawicki,5516,2476,2449,1094,1355
wielkopolskie,302203,"Miejska Górka, gm.",rawicki,7301,3391,3341,1519,1822
wielkopolskie,302204,"Pakosław, gm.",rawicki,3496,1679,1649,704,945
wielkopolskie,302205,"Rawicz, gm.",rawicki,24246,12410,12252,3920,8332
wielkopolskie,302301,"Słupca, m.",słupecki,11718,6514,6411,2670,3741
wielkopolskie,302302,"Lądek, gm.",słupecki,4579,2171,2136,1266,870
wielkopolskie,302303,"Orchowo, gm.",słupecki,3180,1610,1595,791,804
wielkopolskie,302304,"Ostrowite, gm.",słupecki,4388,2169,2144,1272,872
wielkopolskie,302305,"Powidz, gm.",słupecki,2291,1476,1458,537,921
wielkopolskie,302306,"Słupca, gm.",słupecki,7163,3218,3180,1998,1182
wielkopolskie,302307,"Strzałkowo, gm.",słupecki,7693,3777,3675,1821,1854
wielkopolskie,302308,"Zagórów, gm.",słupecki,7159,3052,3006,1633,1373
wielkopolskie,302401,"Obrzycko, m.",szamotulski,1817,970,962,339,623
wielkopolskie,302402,"Duszniki, gm.",szamotulski,6512,3207,3166,1447,1719
wielkopolskie,302403,"Kaźmierz, gm.",szamotulski,5769,2867,2829,864,1965
wielkopolskie,302404,"Obrzycko, gm.",szamotulski,3321,1336,1318,478,840
wielkopolskie,302405,"Ostroróg, gm.",szamotulski,3824,1711,1689,625,1064
wielkopolskie,302406,"Pniewy, gm.",szamotulski,9593,4876,4827,1792,3035
wielkopolskie,302407,"Szamotuły, gm.",szamotulski,22958,12233,12095,3743,8352
wielkopolskie,302408,"Wronki, gm.",szamotulski,16133,8249,8156,2157,5999
wielkopolskie,302501,"Dominowo, gm.",średzki,2246,1094,1076,587,489
wielkopolskie,302502,"Krzykosy, gm.",średzki,5144,2428,2394,1192,1202
wielkopolskie,302503,"Nowe Miasto nad Wartą, gm.",średzki,7033,3269,3233,1476,1757
wielkopolskie,302504,"Środa Wielkopolska, gm.",średzki,23961,12833,12644,4825,7819
wielkopolskie,302505,"Zaniemyśl, gm.",średzki,5078,2693,2646,988,1658
wielkopolskie,302601,"Brodnica, gm.",śremski,3706,1653,1633,522,1111
wielkopolskie,302602,"Dolsk, gm.",śremski,4543,2043,2014,1006,1008
wielkopolskie,302603,"Książ Wielkopolski, gm.",śremski,6514,2963,2911,1490,1421
wielkopolskie,302604,"Śrem, gm.",śremski,31783,17456,17221,6496,10725
wielkopolskie,302701,"Turek, m.",turecki,23649,13531,13382,6710,6672
wielkopolskie,302702,"Brudzew, gm.",turecki,4731,2497,2470,1855,615
wielkopolskie,302703,"Dobra, gm.",turecki,5124,2537,2509,1706,803
wielkopolskie,302704,"Kawęczyn, gm.",turecki,4163,1984,1964,1484,480
wielkopolskie,302705,"Malanów, gm.",turecki,4962,2221,2209,1422,787
wielkopolskie,302706,"Przykona, gm.",turecki,3360,1667,1655,1263,392
wielkopolskie,302707,"Tuliszków, gm.",turecki,8217,4145,4102,2753,1349
wielkopolskie,302708,"Turek, gm.",turecki,6248,3065,3017,2067,950
wielkopolskie,302709,"Władysławów, gm.",turecki,6204,3652,3602,2693,909
wielkopolskie,302801,"Wągrowiec, m.",wągrowiecki,19780,10750,10592,3367,7225
wielkopolskie,302802,"Damasławek, gm.",wągrowiecki,4416,2160,2131,1032,1099
wielkopolskie,302803,"Gołańcz, gm.",wągrowiecki,6500,3020,2980,1190,1790
wielkopolskie,302804,"Mieścisko, gm.",wągrowiecki,4623,2067,2042,854,1188
wielkopolskie,302805,"Skoki, gm.",wągrowiecki,7114,3468,3429,1144,2285
wielkopolskie,302806,"Wapno, gm.",wągrowiecki,2423,1045,1021,378,643
wielkopolskie,302807,"Wągrowiec, gm.",wągrowiecki,8785,3948,3902,1642,2260
wielkopolskie,302901,"Przemęt, gm.",wolsztyński,11159,5537,5480,2322,3158
wielkopolskie,302902,"Siedlec, gm.",wolsztyński,9360,4686,4600,1644,2956
wielkopolskie,302903,"Wolsztyn, gm.",wolsztyński,23214,13167,13001,4076,8925
wielkopolskie,303001,"Kołaczkowo, gm.",wrzesiński,4725,2277,2250,1252,998
wielkopolskie,303002,"Miłosław, gm.",wrzesiński,8309,4019,3975,1704,2271
wielkopolskie,303003,"Nekla, gm.",wrzesiński,5421,2757,2716,1223,1493
wielkopolskie,303004,"Pyzdry, gm.",wrzesiński,5709,2608,2580,1374,1206
wielkopolskie,303005,"Września, gm.",wrzesiński,35270,18850,18626,7789,10837
wielkopolskie,303101,"Złotów, m.",złotowski,15052,8204,8128,2586,5542
wielkopolskie,303102,"Jastrowie, gm.",złotowski,9199,4197,4155,1441,2714
wielkopolskie,303103,"Krajenka, gm.",złotowski,5694,2820,2801,968,1833
wielkopolskie,303104,"Lipka, gm.",złotowski,4352,1844,1827,682,1145
wielkopolskie,303105,"Okonek, gm.",złotowski,7180,3254,3208,1021,2187
wielkopolskie,303106,"Tarnówka, gm.",złotowski,2531,1183,1168,447,721
wielkopolskie,303107,"Zakrzewo, gm.",złotowski,3824,1994,1970,785,1185
wielkopolskie,303108,"Złotów, gm.",złotowski,7053,2924,2901,1046,1855
wielkopolskie,306101,"Kalisz, m.",Kalisz,83977,48136,47563,18272,29291
wielkopolskie,306201,"Konin, m.",Konin,63963,36735,36231,16516,19715
wielkopolskie,306301,"Leszno, m.",Leszno,50286,28273,27924,8599,19325
wielkopolskie,306401,"Poznań, m.",Poznań,431897,272947,269384,74604,194780
zachodniopomorskie,320101,"Białogard, m.",białogardzki,19316,9944,9850,3067,6783
zachodniopomorskie,320102,"Białogard, gm.",białogardzki,6147,2213,2175,699,1476
zachodniopomorskie,320103,"Karlino, gm.",białogardzki,7195,2725,2697,983,1714
zachodniopomorskie,320104,"Tychowo, gm.",białogardzki,5878,2501,2470,607,1863
zachodniopomorskie,320201,"Bierzwnik, gm.",choszczeński,4057,1660,1643,578,1065
zachodniopomorskie,320202,"Choszczno, gm.",choszczeński,18243,8331,8253,2797,5456
zachodniopomorskie,320203,"Drawno, gm.",choszczeński,4627,2005,1986,643,1343
zachodniopomorskie,320204,"Krzęcin, gm.",choszczeński,3106,1085,1070,357,713
zachodniopomorskie,320205,"Pełczyce, gm.",choszczeński,6328,2296,2261,925,1336
zachodniopomorskie,320206,"Recz, gm.",choszczeński,4546,1712,1675,746,929
zachodniopomorskie,320301,"Czaplinek, gm.",drawski,9747,4633,4584,1420,3164
zachodniopomorskie,320302,"Drawsko Pomorskie, gm.",drawski,13635,6445,6368,1930,4438
zachodniopomorskie,320303,"Kalisz Pomorski, gm.",drawski,5836,2362,2337,727,1610
zachodniopomorskie,320304,"Ostrowice, gm.",drawski,2111,878,868,331,537
zachodniopomorskie,320305,"Wierzchowo, gm.",drawski,4112,1907,1886,475,1411
zachodniopomorskie,320306,"Złocieniec, gm.",drawski,12636,6152,6097,2234,3863
zachodniopomorskie,320402,"Goleniów, gm.",goleniowski,27763,14210,14051,4358,9693
zachodniopomorskie,320403,"Maszewo, gm.",goleniowski,6450,2639,2609,960,1649
zachodniopomorskie,320404,"Nowogard, gm.",goleniowski,20124,9414,9254,3062,6192
zachodniopomorskie,320405,"Osina, gm.",goleniowski,2207,1025,1007,417,590
zachodniopomorskie,320406,"Przybiernów, gm.",goleniowski,4155,1590,1562,664,898
zachodniopomorskie,320407,"Stepnica, gm.",goleniowski,3871,1670,1658,455,1203
zachodniopomorskie,320501,"Brojce, gm.",gryficki,2902,1063,1055,357,698
zachodniopomorskie,320502,"Gryfice, gm.",gryficki,19107,9238,9134,2807,6327
zachodniopomorskie,320503,"Karnice, gm.",gryficki,3442,1497,1480,560,920
zachodniopomorskie,320504,"Płoty, gm.",gryficki,7489,3291,3246,1128,2118
zachodniopomorskie,320507,"Rewal, gm.",gryficki,12826,11547,11482,3396,8086
zachodniopomorskie,320508,"Trzebiatów, gm.",gryficki,15508,8128,8046,2636,5410
zachodniopomorskie,320601,"Banie, gm.",gryfiński,5162,2030,2009,816,1193
zachodniopomorskie,320602,"Cedynia, gm.",gryfiński,3511,1308,1286,421,865
zachodniopomorskie,320603,"Chojna, gm.",gryfiński,11088,4984,4921,1784,3137
zachodniopomorskie,320604,"Gryfino, gm.",gryfiński,24883,12916,12688,4850,7838
zachodniopomorskie,320605,"Mieszkowice, gm.",gryfiński,5848,2531,2508,1053,1455
zachodniopomorskie,320606,"Moryń, gm.",gryfiński,3533,1505,1499,601,898
zachodniopomorskie,320607,"Stare Czarnowo, gm.",gryfiński,2986,1350,1338,576,762
zachodniopomorskie,320608,"Trzcińsko-Zdrój, gm.",gryfiński,4458,1788,1777,731,1046
zachodniopomorskie,320609,"Widuchowa, gm.",gryfiński,4316,1652,1632,603,1029
zachodniopomorskie,320701,"Dziwnów, gm.",kamieński,8915,7267,7200,2166,5034
zachodniopomorskie,320702,"Golczewo, gm.",kamieński,4878,2171,2144,693,1451
zachodniopomorskie,320703,"Kamień Pomorski, gm.",kamieński,12726,6483,6404,1993,4411
zachodniopomorskie,320704,"Międzyzdroje, gm.",kamieński,8832,5967,5935,1953,3982
zachodniopomorskie,320705,"Świerzno, gm.",kamieński,3572,1511,1494,381,1113
zachodniopomorskie,320706,"Wolin, gm.",kamieński,10812,5346,5306,1718,3588
zachodniopomorskie,320801,"Kołobrzeg, m.",kołobrzeski,44598,28528,28210,9106,19104
zachodniopomorskie,320802,"Dygowo, gm.",kołobrzeski,4476,1984,1974,639,1335
zachodniopomorskie,320803,"Gościno, gm.",kołobrzeski,4021,1727,1709,574,1135
zachodniopomorskie,320804,"Kołobrzeg, gm.",kołobrzeski,11770,8150,8077,2541,5536
zachodniopomorskie,320805,"Rymań, gm.",kołobrzeski,3265,1440,1429,484,945
zachodniopomorskie,320806,"Siemyśl, gm.",kołobrzeski,2777,1280,1257,492,765
zachodniopomorskie,320807,"Ustronie Morskie, gm.",kołobrzeski,6028,4484,4477,1565,2912
zachodniopomorskie,320901,"Będzino, gm.",koszaliński,6958,3177,3148,1112,2036
zachodniopomorskie,320902,"Biesiekierz, gm.",koszaliński,4392,2239,2201,569,1632
zachodniopomorskie,320903,"Bobolice, gm.",koszaliński,7955,3409,3374,1044,2330
zachodniopomorskie,320904,"Manowo, gm.",koszaliński,5033,2679,2653,727,1926
zachodniopomorskie,320905,"Mielno, gm.",koszaliński,11580,9583,9529,3194,6335
zachodniopomorskie,320906,"Polanów, gm.",koszaliński,7050,2721,2689,869,1820
zachodniopomorskie,320907,"Sianów, gm.",koszaliński,10871,5039,4953,1623,3330
zachodniopomorskie,320908,"Świeszyno, gm.",koszaliński,4850,2452,2416,674,1742
zachodniopomorskie,321001,"Barlinek, gm.",myśliborski,15554,7382,7289,2673,4616
zachodniopomorskie,321002,"Boleszkowice, gm.",myśliborski,2292,914,902,352,550
zachodniopomorskie,321003,"Dębno, gm.",myśliborski,16503,7854,7794,2784,5010
zachodniopomorskie,321004,"Myślibórz, gm.",myśliborski,16769,7531,7454,2581,4873
zachodniopomorskie,321005,"Nowogródek Pomorski, gm.",myśliborski,2617,1071,1063,365,698
zachodniopomorskie,321101,"Dobra (Szczecińska), gm.",policki,11296,6949,6858,1818,5040
zachodniopomorskie,321102,"Kołbaskowo, gm.",policki,7462,3885,3832,1019,2813
zachodniopomorskie,321103,"Nowe Warpno, gm.",policki,1332,737,722,219,503
zachodniopomorskie,321104,"Police, gm.",policki,31618,16245,16021,6208,9813
zachodniopomorskie,321201,"Bielice, gm.",pyrzycki,2365,984,972,487,485
zachodniopomorskie,321202,"Kozielice, gm.",pyrzycki,2121,943,937,433,504
zachodniopomorskie,321203,"Lipiany, gm.",pyrzycki,5002,2147,2108,912,1196
zachodniopomorskie,321204,"Przelewice, gm.",pyrzycki,4251,1599,1573,604,969
zachodniopomorskie,321205,"Pyrzyce, gm.",pyrzycki,15716,7597,7493,3155,4338
zachodniopomorskie,321206,"Warnice, gm.",pyrzycki,2770,1151,1139,658,481
zachodniopomorskie,321301,"Darłowo, m.",sławieński,14460,8684,8606,2667,5939
zachodniopomorskie,321302,"Sławno, m.",sławieński,10607,5159,5102,1901,3201
zachodniopomorskie,321303,"Darłowo, gm.",sławieński,8230,4774,4731,1660,3071
zachodniopomorskie,321304,"Malechowo, gm.",sławieński,5101,2035,2022,718,1304
zachodniopomorskie,321305,"Postomino, gm.",sławieński,8489,4814,4743,1772,2971
zachodniopomorskie,321306,"Sławno, gm.",sławieński,6857,2610,2577,1031,1546
zachodniopomorskie,321401,"Stargard Szczeciński, m.",stargardzki,55476,29950,29614,9974,19640
zachodniopomorskie,321402,"Chociwel, gm.",stargardzki,4920,2065,2023,686,1337
zachodniopomorskie,321403,"Dobrzany, gm.",stargardzki,4058,1614,1600,695,905
zachodniopomorskie,321404,"Dolice, gm.",stargardzki,6323,2484,2460,886,1574
zachodniopomorskie,321405,"Ińsko, gm.",stargardzki,3122,1428,1413,473,940
zachodniopomorskie,321406,"Kobylanka, gm.",stargardzki,3366,1887,1863,688,1175
zachodniopomorskie,321408,"Marianowo, gm.",stargardzki,2474,1061,1050,485,565
zachodniopomorskie,321409,"Stara Dąbrowa, gm.",stargardzki,2824,1073,1057,420,637
zachodniopomorskie,321410,"Stargard Szczeciński, gm.",stargardzki,9209,3777,3719,1412,2307
zachodniopomorskie,321411,"Suchań, gm.",stargardzki,3448,1280,1269,497,772
zachodniopomorskie,321501,"Szczecinek, m.",szczecinecki,32512,17173,16971,5550,11421
zachodniopomorskie,321502,"Barwice, gm.",szczecinecki,7048,2753,2722,918,1804
zachodniopomorskie,321503,"Biały Bór, gm.",szczecinecki,4324,1783,1761,534,1227
zachodniopomorskie,321504,"Borne Sulinowo, gm.",szczecinecki,7918,3796,3733,1127,2606
zachodniopomorskie,321505,"Grzmiąca, gm.",szczecinecki,4033,1482,1474,461,1013
zachodniopomorskie,321506,"Szczecinek, gm.",szczecinecki,7288,2941,2916,1033,1883
zachodniopomorskie,321601,"Świdwin, m.",świdwiński,12529,6001,5926,1942,3984
zachodniopomorskie,321602,"Brzeżno, gm.",świdwiński,2319,934,925,295,630
zachodniopomorskie,321603,"Połczyn-Zdrój, gm.",świdwiński,13404,6361,6273,2270,4003
zachodniopomorskie,321604,"Rąbino, gm.",świdwiński,3139,1239,1224,482,742
zachodniopomorskie,321605,"Sławoborze, gm.",świdwiński,3305,1176,1161,342,819
zachodniopomorskie,321606,"Świdwin, gm.",świdwiński,4891,1931,1909,702,1207
zachodniopomorskie,321701,"Wałcz, m.",wałecki,20856,11350,11200,3379,7821
zachodniopomorskie,321702,"Człopa, gm.",wałecki,4084,1707,1692,543,1149
zachodniopomorskie,321703,"Mirosławiec, gm.",wałecki,4553,1970,1956,522,1434
zachodniopomorskie,321704,"Tuczno, gm.",wałecki,4172,1674,1654,517,1137
zachodniopomorskie,321705,"Wałcz, gm.",wałecki,9823,4043,3999,1224,2775
zachodniopomorskie,321801,"Dobra, gm.",łobeski,3581,1376,1355,478,877
zachodniopomorskie,321802,"Łobez, gm.",łobeski,11489,5232,5154,1522,3632
zachodniopomorskie,321803,"Radowo Małe, gm.",łobeski,3087,1053,1043,290,753
zachodniopomorskie,321804,"Resko, gm.",łobeski,6571,2788,2758,876,1882
zachodniopomorskie,321805,"Węgorzyno, gm.",łobeski,5872,2271,2244,859,1385
zachodniopomorskie,326101,"Koszalin, m.",Koszalin,86641,51849,51262,14903,36359
zachodniopomorskie,326201,"Szczecin, m.",Szczecin,311764,177538,175138,62110,113028
zachodniopomorskie,326301,"Świnoujście, m.",Świnoujście,37191,21746,21505,6662,14843