Code,Gmina,Voivodeship,registered_voters,ballots_cast,valid_votes,duda,komorowski
020101,m. Bolesławiec,dolnośląskie,31458,16537,16280,6780,9500
020102,gm. Bolesławiec,dolnośląskie,10950,5452,5386,2669,2717
020103,gm. Gromadka,dolnośląskie,4514,2245,2221,1285,936
020104,gm. Nowogrodziec,dolnośląskie,11930,5050,4975,2775,2200
020105,gm. Osiecznica,dolnośląskie,5445,2461,2426,1063,1363
020106,gm. Warta Bolesławiecka,dolnośląskie,6691,2938,2891,1478,1413
020201,m. Bielawa,dolnośląskie,25081,12200,12043,5257,6786
020202,m. Dzierżoniów,dolnośląskie,27690,14513,14335,5952,8383
020203,m. Pieszyce,dolnośląskie,7706,3564,3515,1696,1819
020204,m. Piława Górna,dolnośląskie,5255,2438,2408,1191,1217
020205,gm. Dzierżoniów,dolnośląskie,7687,3749,3699,1852,1847
020206,gm. Łagiewniki,dolnośląskie,6075,3003,2971,1659,1312
020207,gm. Niemcza,dolnośląskie,4748,2217,2197,1016,1181
020301,m. Głogów,dolnośląskie,53947,29780,29402,15134,14268
020302,gm. Głogów,dolnośląskie,5152,2878,2828,1608,1220
020303,gm. Jerzmanowa,dolnośląskie,3521,2068,2045,1150,895
020304,gm. Kotla,dolnośląskie,3375,1582,1558,900,658
020305,gm. Pęcław,dolnośląskie,1783,848,836,545,291
020306,gm. Żukowice,dolnośląskie,2784,1306,1291,716,575
020401,gm. Góra,dolnośląskie,16163,7409,7299,3494,3805
020402,gm. Jemielno,dolnośląskie,2496,982,971,535,436
020403,gm. Niechlów,dolnośląskie,3950,1646,1620,890,730
020404,gm. Wąsosz,dolnośląskie,5890,2484,2441,1248,1193
020501,m. Jawor,dolnośląskie,19405,9667,9524,4821,4703
020502,gm. Bolków,dolnośląskie,8665,3872,3820,1705,2115
020503,gm. Męcinka,dolnośląskie,3950,1897,1884,1075,809
020504,gm. Mściwojów,dolnośląskie,3279,1581,1550,747,803
020505,gm. Paszowice,dolnośląskie,3206,1504,1479,751,728
020506,gm. Wądroże Wielkie,dolnośląskie,3265,1454,1438,690,748
020601,m. Karpacz,dolnośląskie,4735,2472,2441,730,1711
020602,m. Kowary,dolnośląskie,9100,4346,4290,1518,2772
020603,m. Piechowice,dolnośląskie,5245,2656,2617,1053,1564
020604,m. Szklarska Poręba,dolnośląskie,5688,3015,2957,1046,1911
020605,gm. Janowice Wielkie,dolnośląskie,3534,1713,1692,644,1048
020606,gm. Jeżów Sudecki,dolnośląskie,5597,2932,2886,1006,1880
020607,gm. Mysłakowice,dolnośląskie,8171,3921,3860,1499,2361
020608,gm. Podgórzyn,dolnośląskie,6646,3287,3243,1055,2188
020609,gm. Stara Kamienica,dolnośląskie,4224,1925,1900,793,1107
020701,m. Kamienna Góra,dolnośląskie,16495,7982,7876,3359,4517
020702,gm. Kamienna Góra,dolnośląskie,6996,3450,3391,1598,1793
020703,gm. Lubawka,dolnośląskie,9149,4582,4503,1888,2615
020704,gm. Marciszów,dolnośląskie,3732,1680,1660,764,896
020801,m. Duszniki-Zdrój,dolnośląskie,4272,2239,2214,863,1351
020802,m. Kłodzko,dolnośląskie,22820,11548,11406,4744,6662
020803,m. Kudowa-Zdrój,dolnośląskie,8910,4849,4789,2076,2713
020804,m. Nowa Ruda,dolnośląskie,18989,8756,8662,3513,5149
020805,m. Polanica-Zdrój,dolnośląskie,6241,3451,3419,1501,1918
020806,gm. Bystrzyca Kłodzka,dolnośląskie,15922,7786,7690,3914,3776
020807,gm. Kłodzko,dolnośląskie,13865,6426,6354,3356,2998
020808,gm. Lądek-Zdrój,dolnośląskie,7391,3679,3628,1645,1983
020809,gm. Lewin Kłodzki,dolnośląskie,1626,723,711,382,329
020810,gm. Międzylesie,dolnośląskie,6007,2710,2674,1194,1480
020811,gm. Nowa Ruda,dolnośląskie,9747,4383,4329,1910,2419
020812,gm. Radków,dolnośląskie,7525,3436,3392,1678,1714
020813,gm. Stronie Śląskie,dolnośląskie,6079,2802,2757,1074,1683
020814,gm. Szczytna,dolnośląskie,5910,2563,2526,1093,1433
020901,m. Chojnów,dolnośląskie,11078,5354,5259,2571,2688
020902,gm. Chojnów,dolnośląskie,7623,3536,3497,1955,1542
020903,gm. Krotoszyce,dolnośląskie,2534,1305,1287,777,510
020904,gm. Kunice,dolnośląskie,4934,2789,2731,1292,1439
020905,gm. Legnickie Pole,dolnośląskie,3752,2019,1989,1073,916
020906,gm. Miłkowice,dolnośląskie,5131,2793,2759,1357,1402
020907,gm. Prochowice,dolnośląskie,5992,2883,2848,1443,1405
020908,gm. Ruja,dolnośląskie,2147,937,925,496,429
021001,m. Lubań,dolnośląskie,17865,8878,8754,3566,5188
021002,m. Świeradów-Zdrój,dolnośląskie,3799,1965,1941,807,1134
021003,gm. Leśna,dolnośląskie,8115,3732,3648,1556,2092
021004,gm. Lubań,dolnośląskie,5203,2402,2373,1079,1294
021005,gm. Olszyna,dolnośląskie,5303,2287,2258,970,1288
021006,gm. Platerówka,dolnośląskie,1302,638,630,359,271
021007,gm. Siekierczyn,dolnośląskie,4066,1966,1943,907,1036
021101,m. Lubin,dolnośląskie,58308,33135,32728,19501,13227
021102,gm. Lubin,dolnośląskie,11571,6589,6498,3946,2552
021103,gm. Rudna,dolnośląskie,6123,3271,3223,2173,1050
021104,gm. Ścinawa,dolnośląskie,8123,4275,4215,2884,1331
021201,gm. Gryfów Śląski,dolnośląskie,8116,3633,3607,1561,2046
021202,gm. Lubomierz,dolnośląskie,4872,2067,2031,906,1125
021203,gm. Lwówek Śląski,dolnośląskie,14147,6540,6476,2882,3594
021204,gm. Mirsk,dolnośląskie,7081,3093,3044,1485,1559
021205,gm. Wleń,dolnośląskie,3601,1696,1663,721,942
021301,gm. Cieszków,dolnośląskie,3746,1840,1809,977,832
021302,gm. Krośnice,dolnośląskie,6403,3176,3144,1721,1423
021303,gm. Milicz,dolnośląskie,19486,10046,9901,4741,5160
021401,m. Oleśnica,dolnośląskie,30182,16724,16449,6878,9571
021402,gm. Bierutów,dolnośląskie,8108,3814,3667,1783,1884
021403,gm. Dobroszyce,dolnośląskie,5183,2465,2425,1257,1168
021404,gm. Dziadowa Kłoda,dolnośląskie,3617,1606,1577,568,1009
021405,gm. Międzybórz,dolnośląskie,3981,1912,1888,714,1174
021406,gm. Oleśnica,dolnośląskie,9960,4666,4605,2192,2413
021407,gm. Syców,dolnośląskie,13291,6849,6750,2733,4017
021408,gm. Twardogóra,dolnośląskie,10525,5175,5110,2210,2900
021501,m. Oława,dolnośląskie,25634,14867,14658,6695,7963
021502,gm. Domaniów,dolnośląskie,4177,2087,2057,1207,850
021503,gm. Jelcz-Laskowice,dolnośląskie,18101,10018,9922,5324,4598
021504,gm. Oława,dolnośląskie,11690,6402,6329,3537,2792
021601,gm. Chocianów,dolnośląskie,10236,5707,5647,3977,1670
021602,gm. Gaworzyce,dolnośląskie,3077,1715,1689,1082,607
021603,gm. Grębocice,dolnośląskie,4177,2069,2053,1328,725
021604,gm. Polkowice,dolnośląskie,20749,11471,11335,7110,4225
021605,gm. Przemków,dolnośląskie,6949,3350,3309,1999,1310
021606,gm. Radwanice,dolnośląskie,3698,1934,1911,1157,754
021701,gm. Borów,dolnośląskie,4331,2319,2287,1389,898
021702,gm. Kondratowice,dolnośląskie,3710,1715,1688,921,767
021703,gm. Przeworno,dolnośląskie,4092,1871,1846,1066,780
021704,gm. Strzelin,dolnośląskie,18360,9630,9526,4337,5189
021705,gm. Wiązów,dolnośląskie,5939,3009,2971,1882,1089
021801,gm. Kostomłoty,dolnośląskie,5732,2720,2689,1539,1150
021802,gm. Malczyce,dolnośląskie,4766,2283,2268,1147,1121
021803,gm. Miękinia,dolnośląskie,11098,6012,5901,2717,3184
021804,gm. Środa Śląska,dolnośląskie,15692,7803,7696,3568,4128
021805,gm. Udanin,dolnośląskie,4451,2155,2116,1197,919
021901,m. Świdnica,dolnośląskie,47174,26015,25700,10111,15589
021902,m. Świebodzice,dolnośląskie,18358,9369,9237,3962,5275
021903,gm. Dobromierz,dolnośląskie,4306,2047,2019,1091,928
021904,gm. Jaworzyna Śląska,dolnośląskie,8360,3799,3747,1999,1748
021905,gm. Marcinowice,dolnośląskie,5170,2695,2661,1463,1198
021906,gm. Strzegom,dolnośląskie,21410,10614,10477,4968,5509
021907,gm. Świdnica,dolnośląskie,13362,6619,6540,2953,3587
021908,gm. Żarów,dolnośląskie,10060,4923,4854,2316,2538
022001,gm. Oborniki Śląskie,dolnośląskie,15722,9121,8991,3879,5112
022002,gm. Prusice,dolnośląskie,7484,3555,3514,1962,1552
022003,gm. Trzebnica,dolnośląskie,18491,10048,9907,4736,5171
022004,gm. Wisznia Mała,dolnośląskie,7726,4566,4494,2252,2242
022005,gm. Zawonia,dolnośląskie,4657,2179,2146,1016,1130
022006,gm. Żmigród,dolnośląskie,11862,5428,5344,2513,2831
022101,m. Boguszów-Gorce,dolnośląskie,12715,5640,5537,2106,3431
022102,m. Jedlina-Zdrój,dolnośląskie,3914,1918,1875,732,1143
022103,m. Szczawno-Zdrój,dolnośląskie,4993,2944,2896,946,1950
022104,gm. Czarny Bór,dolnośląskie,3899,2076,2035,1029,1006
022105,gm. Głuszyca,dolnośląskie,7218,3431,3380,1328,2052
022106,gm. Mieroszów,dolnośląskie,5605,2464,2432,938,1494
022107,gm. Stare Bogaczowice,dolnośląskie,3390,1706,1675,697,978
022108,gm. Walim,dolnośląskie,4658,2141,2104,917,1187
022201,gm. Brzeg Dolny,dolnośląskie,12986,6913,6794,3013,3781
022202,gm. Wińsko,dolnośląskie,6927,3235,3211,2064,1147
022203,gm. Wołów,dolnośląskie,19854,10010,9898,4645,5253
022301,gm. Czernica,dolnośląskie,10059,6478,6365,2823,3542
022302,gm. Długołęka,dolnośląskie,21310,13060,12871,6097,6774
022303,gm. Jordanów Śląski,dolnośląskie,2560,1439,1426,794,632
022304,gm. Kąty Wrocławskie,dolnośląskie,16807,9613,9483,4459,5024
022305,gm. Kobierzyce,dolnośląskie,13628,8092,7970,3285,4685
022306,gm. Mietków,dolnośląskie,3174,1650,1632,774,858
022307,gm. Sobótka,dolnośląskie,10435,5287,5210,2539,2671
022308,gm. Siechnice,dolnośląskie,14537,9137,8989,4061,4928
022309,gm. Żórawina,dolnośląskie,7904,4402,4319,1982,2337
022401,gm. Bardo,dolnośląskie,4406,2168,2137,1047,1090
022402,gm. Ciepłowody,dolnośląskie,2547,1095,1088,562,526
022403,gm. Kamieniec Ząbkowicki,dolnośląskie,6855,3319,3277,1695,1582
022404,gm. Stoszowice,dolnośląskie,4476,1977,1936,927,1009
022405,gm. Ząbkowice Śląskie,dolnośląskie,18187,9397,9282,4206,5076
022406,gm. Ziębice,dolnośląskie,14392,6545,6473,3212,3261
022407,gm. Złoty Stok,dolnośląskie,3811,1804,1775,885,890
022501,m. Zawidów,dolnośląskie,3381,1711,1673,854,819
022502,m. Zgorzelec,dolnośląskie,25722,13464,13247,6038,7209
022503,gm. Bogatynia,dolnośląskie,19182,9177,8983,4904,4079
022504,gm. Pieńsk,dolnośląskie,7305,3065,3020,1388,1632
022505,gm. Sulików,dolnośląskie,4862,2387,2366,1448,918
022506,gm. Węgliniec,dolnośląskie,6994,3205,3152,1470,1682
022507,gm. Zgorzelec,dolnośląskie,6673,3154,3101,1572,1529
022601,m. Wojcieszów,dolnośląskie,3052,1300,1282,474,808
022602,m. Złotoryja,dolnośląskie,13263,6681,6607,3036,3571
022603,gm. Pielgrzymka,dolnośląskie,3714,1659,1632,849,783
022604,gm. Świerzawa,dolnośląskie,6227,2729,2713,1184,1529
022605,gm. Zagrodno,dolnośląskie,4438,2119,2098,1243,855
022606,gm. Złotoryja,dolnośląskie,5632,2679,2646,1432,1214
026101,m. Jelenia Góra,dolnośląskie,66154,35433,34895,12995,21900
026201,m. Legnica,dolnośląskie,78830,41782,41212,19225,21987
026401,m. Wrocław,dolnośląskie,502829,308125,303187,124803,178384
026501,m. Wałbrzych,dolnośląskie,92218,45129,44385,16572,27813
040101,m. Aleksandrów Kujawski,kujawsko-pomorskie,9965,5234,5167,2186,2981
040102,m. Ciechocinek,kujawsko-pomorskie,11383,7306,7211,3128,4083
040103,m. Nieszawa,kujawsko-pomorskie,1616,863,852,405,447
040104,gm. Aleksandrów Kujawski,kujawsko-pomorskie,8898,4225,4164,2310,1854
040105,gm. Bądkowo,kujawsko-pomorskie,3536,1717,1679,904,775
040106,gm. Koneck,kujawsko-pomorskie,2686,1214,1190,736,454
040107,gm. Raciążek,kujawsko-pomorskie,2559,1318,1307,669,638
040108,gm. Waganiec,kujawsko-pomorskie,3621,1785,1766,1092,674
040109,gm. Zakrzewo,kujawsko-pomorskie,2899,1362,1352,715,637
040201,m. Brodnica,kujawsko-pomorskie,21571,11505,11323,5095,6228
040202,gm. Bobrowo,kujawsko-pomorskie,5048,2387,2365,1169,1196
040203,gm. Brodnica,kujawsko-pomorskie,5930,2856,2817,1382,1435
040204,gm. Brzozie,kujawsko-pomorskie,2928,1512,1485,900,585
040205,gm. Górzno,kujawsko-pomorskie,3180,1577,1559,901,658
040206,gm. Bartniczka,kujawsko-pomorskie,3661,1797,1777,1009,768
040207,gm. Jabłonowo Pomorskie,kujawsko-pomorskie,7139,3186,3105,1585,1520
040208,gm. Osiek,kujawsko-pomorskie,3218,1410,1384,823,561
040209,gm. Świedziebnia,kujawsko-pomorskie,4166,1911,1894,1153,741
040210,gm. Zbiczno,kujawsko-pomorskie,3867,1978,1955,903,1052
040301,gm. Białe Błota,kujawsko-pomorskie,14593,8676,8536,3201,5335
040302,gm. Dąbrowa Chełmińska,kujawsko-pomorskie,6190,2896,2847,1301,1546
040303,gm. Dobrcz,kujawsko-pomorskie,8456,4406,4352,1841,2511
040304,gm. Koronowo,kujawsko-pomorskie,19365,9180,9080,3656,5424
040305,gm. Nowa Wieś Wielka,kujawsko-pomorskie,7429,3777,3719,1523,2196
040306,gm. Osielsko,kujawsko-pomorskie,9375,6023,5939,1911,4028
040307,gm. Sicienko,kujawsko-pomorskie,7754,4089,4044,1522,2522
040308,gm. Solec Kujawski,kujawsko-pomorskie,12819,6817,6692,2688,4004
040401,m. Chełmno,kujawsko-pomorskie,15299,8003,7893,2944,4949
040402,gm. Chełmno,kujawsko-pomorskie,4413,1821,1792,809,983
040403,gm. Kijewo Królewskie,kujawsko-pomorskie,3496,1670,1652,776,876
040404,gm. Lisewo,kujawsko-pomorskie,4085,1872,1846,882,964
040405,gm. Papowo Biskupie,kujawsko-pomorskie,3453,1476,1453,662,791
040406,gm. Stolno,kujawsko-pomorskie,4060,1926,1910,939,971
040407,gm. Unisław,kujawsko-pomorskie,5377,2590,2552,1250,1302
040501,m. Golub-Dobrzyń,kujawsko-pomorskie,9971,5026,4966,2408,2558
040502,gm. Ciechocin,kujawsko-pomorskie,3166,1529,1517,940,577
040503,gm. Golub-Dobrzyń,kujawsko-pomorskie,6914,3087,3056,1727,1329
040504,gm. Kowalewo Pomorskie,kujawsko-pomorskie,9123,4367,4305,2146,2159
040505,gm. Radomin,kujawsko-pomorskie,3317,1583,1567,1057,510
040506,gm. Zbójno,kujawsko-pomorskie,3462,1495,1482,819,663
040601,gm. Grudziądz,kujawsko-pomorskie,9234,4530,4491,1993,2498
040602,gm. Gruta,kujawsko-pomorskie,5214,2449,2422,1142,1280
040603,gm. Łasin,kujawsko-pomorskie,6420,2938,2905,1311,1594
040604,gm. Radzyń Chełmiński,kujawsko-pomorskie,3788,1542,1515,756,759
040605,gm. Rogóźno,kujawsko-pomorskie,3219,1473,1465,764,701
040606,gm. Świecie nad Osą,kujawsko-pomorskie,3326,1399,1376,703,673
040701,m. Inowrocław,kujawsko-pomorskie,61076,33634,33141,12863,20278
040702,gm. Dąbrowa Biskupia,kujawsko-pomorskie,4057,1750,1722,883,839
040703,gm. Gniewkowo,kujawsko-pomorskie,11405,5435,5340,2487,2853
040704,gm. Inowrocław,kujawsko-pomorskie,9262,4553,4485,2116,2369
040705,gm. Janikowo,kujawsko-pomorskie,10870,5366,5281,2642,2639
040706,gm. Kruszwica,kujawsko-pomorskie,15711,7807,7713,3711,4002
040707,gm. Pakość,kujawsko-pomorskie,7904,3993,3937,1788,2149
040708,gm. Rojewo,kujawsko-pomorskie,3683,1733,1697,966,731
040709,gm. Złotniki Kujawskie,kujawsko-pomorskie,7310,3514,3459,1565,1894
040801,m. Lipno,kujawsko-pomorskie,11483,5713,5632,2885,2747
040802,gm. Bobrowniki,kujawsko-pomorskie,2455,1147,1129,550,579
040803,gm. Chrostkowo,kujawsko-pomorskie,2416,985,978,608,370
040804,gm. Dobrzyń nad Wisłą,kujawsko-pomorskie,6294,2781,2734,1490,1244
040805,gm. Kikół,kujawsko-pomorskie,5717,2459,2421,1282,1139
040806,gm. Lipno,kujawsko-pomorskie,9172,3975,3917,2195,1722
040807,gm. Skępe,kujawsko-pomorskie,6024,2882,2844,1473,1371
040808,gm. Tłuchowo,kujawsko-pomorskie,3636,1644,1618,1047,571
040809,gm. Wielgie,kujawsko-pomorskie,5252,2301,2261,1278,983
040901,gm. Dąbrowa,kujawsko-pomorskie,3704,1676,1663,798,865
040902,gm. Jeziora Wielkie,kujawsko-pomorskie,3991,1813,1790,923,867
040903,gm. Mogilno,kujawsko-pomorskie,19954,10078,9937,4392,5545
040904,gm. Strzelno,kujawsko-pomorskie,9576,4771,4713,2036,2677
041001,gm. Kcynia,kujawsko-pomorskie,10641,5119,5056,2079,2977
041002,gm. Mrocza,kujawsko-pomorskie,7145,3407,3361,1336,2025
041003,gm. Nakło nad Notecią,kujawsko-pomorskie,25820,13492,13288,5071,8217
041004,gm. Sadki,kujawsko-pomorskie,5679,2766,2727,1177,1550
041005,gm. Szubin,kujawsko-pomorskie,18700,9553,9427,3765,5662
041101,m. Radziejów,kujawsko-pomorskie,4820,2605,2574,1278,1296
041102,gm. Bytoń,kujawsko-pomorskie,3105,1467,1444,892,552
041103,gm. Dobre,kujawsko-pomorskie,4483,2124,2096,1214,882
041104,gm. Osięciny,kujawsko-pomorskie,6461,3035,2990,1720,1270
041105,gm. Piotrków Kujawski,kujawsko-pomorskie,7662,3623,3581,2098,1483
041106,gm. Radziejów,kujawsko-pomorskie,3602,1730,1707,1046,661
041107,gm. Topólka,kujawsko-pomorskie,4108,1964,1950,1027,923
041201,m. Rypin,kujawsko-pomorskie,13043,6756,6661,3118,3543
041202,gm. Brzuze,kujawsko-pomorskie,4305,1865,1838,1031,807
041203,gm. Rogowo,kujawsko-pomorskie,3868,1664,1625,1064,561
041204,gm. Rypin,kujawsko-pomorskie,5912,2496,2466,1353,1113
041205,gm. Skrwilno,kujawsko-pomorskie,4844,2203,2182,1481,701
041206,gm. Wąpielsk,kujawsko-pomorskie,3306,1463,1448,819,629
041301,gm. Kamień Krajeński,kujawsko-pomorskie,5436,2622,2591,1051,1540
041302,gm. Sępólno Krajeńskie,kujawsko-pomorskie,12492,6301,6227,2293,3934
041303,gm. Sośno,kujawsko-pomorskie,4012,1743,1729,734,995
041304,gm. Więcbork,kujawsko-pomorskie,10371,4920,4868,1995,2873
041401,gm. Bukowiec,kujawsko-pomorskie,3985,1814,1784,900,884
041402,gm. Dragacz,kujawsko-pomorskie,5814,2717,2675,1142,1533
041403,gm. Drzycim,kujawsko-pomorskie,3982,1889,1876,938,938
041404,gm. Jeżewo,kujawsko-pomorskie,6208,3027,2989,1457,1532
041405,gm. Lniano,kujawsko-pomorskie,3308,1743,1724,817,907
041406,gm. Nowe,kujawsko-pomorskie,8319,3567,3529,1278,2251
041407,gm. Osie,kujawsko-pomorskie,4335,2109,2084,792,1292
041408,gm. Pruszcz,kujawsko-pomorskie,7454,3830,3772,1615,2157
041409,gm. Świecie,kujawsko-pomorskie,26625,13687,13542,4968,8574
041410,gm. Świekatowo,kujawsko-pomorskie,2801,1372,1347,616,731
041411,gm. Warlubie,kujawsko-pomorskie,5053,2155,2134,1002,1132
041501,m. Chełmża,kujawsko-pomorskie,11463,5369,5308,2333,2975
041502,gm. Chełmża,kujawsko-pomorskie,7673,3380,3313,1693,1620
041503,gm. Czernikowo,kujawsko-pomorskie,6992,3060,3019,1536,1483
041504,gm. Lubicz,kujawsko-pomorskie,14401,7990,7902,3873,4029
041505,gm. Łubianka,kujawsko-pomorskie,5137,2701,2649,1301,1348
041506,gm. Łysomice,kujawsko-pomorskie,7375,3772,3722,1791,1931
041507,gm. Obrowo,kujawsko-pomorskie,11197,6076,5976,2909,3067
041508,gm. Wielka Nieszawka,kujawsko-pomorskie,3634,2048,2014,826,1188
041509,gm. Zławieś Wielka,kujawsko-pomorskie,9990,5118,5049,2187,2862
041601,gm. Cekcyn,kujawsko-pomorskie,5287,2673,2642,1155,1487
041602,gm. Gostycyn,kujawsko-pomorskie,4131,2070,2048,1007,1041
041603,gm. Kęsowo,kujawsko-pomorskie,3541,1701,1676,791,885
041604,gm. Lubiewo,kujawsko-pomorskie,4615,2486,2464,1235,1229
041605,gm. Śliwice,kujawsko-pomorskie,4373,2390,2364,1227,1137
041606,gm. Tuchola,kujawsko-pomorskie,15930,8624,8513,3779,4734
041701,m. Wąbrzeźno,kujawsko-pomorskie,10784,5405,5341,1936,3405
041702,gm. Dębowa Łąka,kujawsko-pomorskie,2544,1111,1103,529,574
041703,gm. Książki,kujawsko-pomorskie,3381,1514,1489,727,762
041704,gm. Płużnica,kujawsko-pomorskie,3894,1734,1677,737,940
041705,gm. Wąbrzeźno,kujawsko-pomorskie,6785,2848,2807,1329,1478
041801,m. Kowal,kujawsko-pomorskie,2905,1548,1513,725,788
041802,gm. Baruchowo,kujawsko-pomorskie,2918,1277,1264,676,588
041803,gm. Boniewo,kujawsko-pomorskie,2793,1297,1280,733,547
041804,gm. Brześć Kujawski,kujawsko-pomorskie,9267,4166,4097,1927,2170
041805,gm. Choceń,kujawsko-pomorskie,6521,2658,2613,1332,1281
041806,gm. Chodecz,kujawsko-pomorskie,5158,2141,2110,1190,920
041807,gm. Fabianki,kujawsko-pomorskie,7587,3359,3325,1410,1915
041808,gm. Izbica Kujawska,kujawsko-pomorskie,6163,2613,2571,1746,825
041809,gm. Kowal,kujawsko-pomorskie,3212,1402,1392,817,575
041810,gm. Lubanie,kujawsko-pomorskie,3758,1818,1797,1186,611
041811,gm. Lubień Kujawski,kujawsko-pomorskie,6075,2624,2580,1520,1060
041812,gm. Lubraniec,kujawsko-pomorskie,8043,3921,3873,2154,1719
041813,gm. Włocławek,kujawsko-pomorskie,5623,2780,2717,1300,1417
041901,gm. Barcin,kujawsko-pomorskie,11552,5671,5606,1998,3608
041902,gm. Gąsawa,kujawsko-pomorskie,4243,2195,2161,1066,1095
041903,gm. Janowiec Wielkopolski,kujawsko-pomorskie,7320,3557,3503,1432,2071
041904,gm. Łabiszyn,kujawsko-pomorskie,7692,3689,3623,1625,1998
041905,gm. Rogowo,kujawsko-pomorskie,5451,2763,2723,1235,1488
041906,gm. Żnin,kujawsko-pomorskie,19556,10036,9865,4422,5443
046101,m. Bydgoszcz,kujawsko-pomorskie,278713,160312,158089,61587,96502
046201,m. Grudziądz,kujawsko-pomorskie,74155,38812,38229,14674,23555
046301,m. Toruń,kujawsko-pomorskie,156518,92568,91143,37854,53289
046401,m. Włocławek,kujawsko-pomorskie,90798,47488,46650,18662,27988
060101,m. Międzyrzec Podlaski,lubelskie,13673,7763,7667,4934,2733
060102,m. Terespol,lubelskie,4588,2498,2455,1384,1071
060103,gm. Biała Podlaska,lubelskie,10626,5803,5692,3408,2284
060104,gm. Drelów,lubelskie,4423,2076,2045,1474,571
060105,gm. Janów Podlaski,lubelskie,4263,2072,2037,1271,766
060106,gm. Kodeń,lubelskie,3307,1731,1696,903,793
060107,gm. Konstantynów,lubelskie,3265,1663,1635,1029,606
060108,gm. Leśna Podlaska,lubelskie,3422,1786,1764,1218,546
060109,gm. Łomazy,lubelskie,4182,2259,2221,1463,758
060110,gm. Międzyrzec Podlaski,lubelskie,8111,4478,4437,3447,990
060111,gm. Piszczac,lubelskie,5884,2739,2698,1865,833
060112,gm. Rokitno,lubelskie,2544,1210,1191,743,448
060113,gm. Rossosz,lubelskie,1898,1031,1011,742,269
060114,gm. Sławatycze,lubelskie,2015,1009,998,487,511
060115,gm. Sosnówka,lubelskie,2166,983,974,632,342
060116,gm. Terespol,lubelskie,5406,2888,2856,1906,950
060117,gm. Tuczna,lubelskie,2675,1205,1191,785,406
060118,gm. Wisznice,lubelskie,4119,2095,2073,1294,779
060119,gm. Zalesie,lubelskie,3553,1696,1677,1088,589
060201,m. Biłgoraj,lubelskie,21353,11825,11689,7513,4176
060202,gm. Aleksandrów,lubelskie,2546,1383,1376,1148,228
060203,gm. Biłgoraj,lubelskie,10319,5606,5531,4540,991
060204,gm. Biszcza,lubelskie,3191,1579,1553,1273,280
060205,gm. Frampol,lubelskie,5134,2654,2628,2070,558
060206,gm. Goraj,lubelskie,3467,1794,1777,1507,270
060207,gm. Józefów,lubelskie,5767,2712,2685,1754,931
060208,gm. Księżpol,lubelskie,5434,2810,2781,2276,505
060209,gm. Łukowa,lubelskie,3479,1935,1920,1546,374
060210,gm. Obsza,lubelskie,3461,1791,1776,1450,326
060211,gm. Potok Górny,lubelskie,4623,2551,2526,2198,328
060212,gm. Tarnogród,lubelskie,5485,2998,2958,2251,707
060213,gm. Tereszpol,lubelskie,3206,1564,1539,1175,364
060214,gm. Turobin,lubelskie,5487,3153,3126,2551,575
060301,m. Rejowiec Fabryczny,lubelskie,3660,1615,1591,1003,588
060302,gm. Białopole,lubelskie,2553,1098,1080,708,372
060303,gm. Chełm,lubelskie,11137,5489,5409,3680,1729
060304,gm. Dorohusk,lubelskie,5412,2442,2413,1726,687
060305,gm. Dubienka,lubelskie,2105,928,918,510,408
060306,gm. Kamień,lubelskie,3303,1531,1513,1017,496
060307,gm. Leśniowice,lubelskie,3117,1287,1270,770,500
060308,gm. Rejowiec Fabryczny,lubelskie,3573,1589,1568,1162,406
060309,gm. Ruda-Huta,lubelskie,3730,1680,1657,1020,637
060310,gm. Sawin,lubelskie,4679,2080,2063,1378,685
060311,gm. Siedliszcze,lubelskie,5578,2291,2250,1493,757
060312,gm. Wierzbica,lubelskie,4262,2073,2044,1547,497
060313,gm. Wojsławice,lubelskie,3291,1490,1471,1052,419
060314,gm. Żmudź,lubelskie,2668,1184,1171,717,454
060315,gm. Rejowiec,lubelskie,5344,2248,2218,1506,712
060401,m. Hrubieszów,lubelskie,15578,7839,7755,4502,3253
060402,gm. Dołhobyczów,lubelskie,4838,2000,1986,1372,614
060403,gm. Horodło,lubelskie,4445,1808,1791,1174,617
060404,gm. Hrubieszów,lubelskie,8406,3698,3670,2604,1066
060405,gm. Mircze,lubelskie,6441,2770,2738,1802,936
060406,gm. Trzeszczany,lubelskie,3624,1611,1588,1173,415
060407,gm. Uchanie,lubelskie,3991,1892,1881,1422,459
060408,gm. Werbkowice,lubelskie,7921,3678,3639,2709,930
060501,gm. Batorz,lubelskie,2760,1671,1662,1435,227
060502,gm. Chrzanów,lubelskie,2471,1648,1627,1547,80
060503,gm. Dzwola,lubelskie,5326,3253,3232,2940,292
060504,gm. Godziszów,lubelskie,4836,3442,3411,3213,198
060505,gm. Janów Lubelski,lubelskie,13263,7729,7650,5907,1743
060506,gm. Modliborzyce,lubelskie,5826,3101,3071,2456,615
060507,gm. Potok Wielki,lubelskie,3886,2048,2030,1690,340
060601,m. Krasnystaw,lubelskie,16124,8212,8074,4448,3626
060602,gm. Fajsławice,lubelskie,3889,2099,2074,1662,412
060603,gm. Gorzków,lubelskie,3124,1508,1487,1089,398
060604,gm. Izbica,lubelskie,7037,3230,3196,2275,921
060605,gm. Krasnystaw,lubelskie,7213,3402,3374,2207,1167
060606,gm. Kraśniczyn,lubelskie,3300,1512,1494,980,514
060607,gm. Łopiennik Górny,lubelskie,3433,1647,1633,1263,370
060609,gm. Rudnik,lubelskie,2720,1186,1175,873,302
060610,gm. Siennica Różana,lubelskie,3472,1598,1568,936,632
060611,gm. Żółkiewka,lubelskie,4815,2248,2232,1695,537
060701,m. Kraśnik,lubelskie,28876,15840,15586,9615,5971
060702,gm. Annopol,lubelskie,7251,3562,3517,2472,1045
060703,gm. Dzierzkowice,lubelskie,4332,2292,2251,1741,510
060704,gm. Gościeradów,lubelskie,5868,2743,2720,2037,683
060705,gm. Kraśnik,lubelskie,5758,3068,3036,2372,664
060706,gm. Szastarka,lubelskie,4784,2668,2654,2262,392
060707,gm. Trzydnik Duży,lubelskie,5379,2589,2557,1919,638
060708,gm. Urzędów,lubelskie,6955,3855,3756,2914,842
060709,gm. Wilkołaz,lubelskie,4348,2571,2527,2182,345
060710,gm. Zakrzówek,lubelskie,5474,2848,2832,2320,512
060801,m. Lubartów,lubelskie,17890,10613,10414,6217,4197
060802,gm. Abramów,lubelskie,3393,2029,2009,1708,301
060803,gm. Firlej,lubelskie,4739,2269,2239,1605,634
060804,gm. Jeziorzany,lubelskie,2355,1145,1133,872,261
060805,gm. Kamionka,lubelskie,5096,2599,2551,1769,782
060806,gm. Kock,lubelskie,5282,2853,2811,2072,739
060807,gm. Lubartów,lubelskie,8641,4821,4747,3397,1350
060808,gm. Michów,lubelskie,5057,2553,2505,1906,599
060809,gm. Niedźwiada,lubelskie,5021,2801,2786,2201,585
060810,gm. Ostrów Lubelski,lubelskie,4312,2355,2325,1804,521
060811,gm. Ostrówek,lubelskie,3167,1684,1669,1188,481
060812,gm. Serniki,lubelskie,3937,2305,2281,1833,448
060813,gm. Uścimów,lubelskie,2645,1376,1365,968,397
060901,gm. Bełżyce,lubelskie,10786,5863,5709,4242,1467
060902,gm. Borzechów,lubelskie,3176,1935,1914,1593,321
060903,gm. Bychawa,lubelskie,9690,5037,4984,3807,1177
060904,gm. Garbów,lubelskie,7072,4050,4006,2866,1140
060905,gm. Głusk,lubelskie,7575,4645,4600,3155,1445
060906,gm. Jabłonna,lubelskie,6278,3055,3025,2188,837
060907,gm. Jastków,lubelskie,10490,6368,6304,4377,1927
060908,gm. Konopnica,lubelskie,10271,6186,6074,3688,2386
060909,gm. Krzczonów,lubelskie,3939,1937,1906,1406,500
060910,gm. Niedrzwica Duża,lubelskie,9014,5241,5166,3700,1466
060911,gm. Niemce,lubelskie,14496,8520,8410,5794,2616
060912,gm. Strzyżewice,lubelskie,6126,3171,3135,2340,795
060913,gm. Wojciechów,lubelskie,4821,2564,2527,1911,616
060914,gm. Wólka,lubelskie,8411,5073,4993,3471,1522
060915,gm. Wysokie,lubelskie,3942,1976,1957,1501,456
060916,gm. Zakrzew,lubelskie,2566,1278,1265,1050,215
061001,gm. Cyców,lubelskie,6151,3081,3037,2196,841
061002,gm. Ludwin,lubelskie,4214,2254,2228,1641,587
061003,gm. Łęczna,lubelskie,18894,11055,10919,7784,3135
061004,gm. Milejów,lubelskie,7324,3473,3405,2446,959
061005,gm. Puchaczów,lubelskie,4315,2467,2443,1919,524
061006,gm. Spiczyn,lubelskie,4356,2089,2046,1487,559
061101,m. Łuków,lubelskie,23979,13951,13756,8521,5235
061102,m. Stoczek Łukowski,lubelskie,2146,1290,1275,782,493
061103,gm. Adamów,lubelskie,4625,2406,2382,1682,700
061104,gm. Krzywda,lubelskie,8194,4247,4207,3206,1001
061105,gm. Łuków,lubelskie,13320,7689,7611,5967,1644
061106,gm. Serokomla,lubelskie,3335,1669,1650,1324,326
061107,gm. Stanin,lubelskie,7627,4145,4107,3175,932
061108,gm. Stoczek Łukowski,lubelskie,6550,3677,3630,3016,614
061109,gm. Trzebieszów,lubelskie,5869,3607,3586,3125,461
061110,gm. Wojcieszków,lubelskie,5513,2906,2876,2209,667
061111,gm. Wola Mysłowska,lubelskie,4032,2289,2271,1848,423
061201,gm. Chodel,lubelskie,5336,2751,2719,2224,495
061202,gm. Józefów nad Wisłą,lubelskie,5553,2554,2534,1754,780
061203,gm. Karczmiska,lubelskie,4736,2139,2113,1429,684
061204,gm. Łaziska,lubelskie,4093,2018,1987,1457,530
061205,gm. Opole Lubelskie,lubelskie,14924,7459,7351,4866,2485
061206,gm. Poniatowa,lubelskie,11984,6378,6303,4229,2074
061207,gm. Wilków,lubelskie,3814,1999,1969,1568,401
061301,gm. Dębowa Kłoda,lubelskie,3283,1520,1498,906,592
061302,gm. Jabłoń,lubelskie,3140,1790,1772,1380,392
061303,gm. Milanów,lubelskie,3219,1560,1537,1119,418
061304,gm. Parczew,lubelskie,12212,6304,6227,3699,2528
061305,gm. Podedwórze,lubelskie,1467,731,721,481,240
061306,gm. Siemień,lubelskie,3906,1943,1920,1412,508
061307,gm. Sosnowica,lubelskie,2222,1091,1080,697,383
061401,m. Puławy,lubelskie,39299,23366,23026,12725,10301
061402,gm. Baranów,lubelskie,3355,1731,1712,1282,430
061403,gm. Janowiec,lubelskie,3099,1644,1632,1073,559
061404,gm. Kazimierz Dolny,lubelskie,5975,3278,3227,2064,1163
061405,gm. Końskowola,lubelskie,7339,4156,4097,2812,1285
061406,gm. Kurów,lubelskie,6272,3456,3403,2525,878
061407,gm. Markuszów,lubelskie,2469,1358,1332,1011,321
061408,gm. Nałęczów,lubelskie,8454,5143,5078,3266,1812
061409,gm. Puławy,lubelskie,9593,5159,5085,3398,1687
061410,gm. Wąwolnica,lubelskie,3856,2026,2000,1559,441
061411,gm. Żyrzyn,lubelskie,5363,3121,3079,2377,702
061501,m. Radzyń Podlaski,lubelskie,12925,7365,7246,4423,2823
061502,gm. Borki,lubelskie,4829,2271,2251,1536,715
061503,gm. Czemierniki,lubelskie,3645,2084,2053,1478,575
061504,gm. Kąkolewnica,lubelskie,6625,3578,3541,2775,766
061505,gm. Komarówka Podlaska,lubelskie,3775,2037,2005,1442,563
061506,gm. Radzyń Podlaski,lubelskie,6409,3433,3405,2624,781
061507,gm. Ulan-Majorat,lubelskie,4776,2718,2696,2130,566
061508,gm. Wohyń,lubelskie,5748,2806,2762,1943,819
061601,m. Dęblin,lubelskie,13680,7655,7526,4336,3190
061602,gm. Kłoczew,lubelskie,5859,3443,3394,2824,570
061603,gm. Nowodwór,lubelskie,3355,1925,1886,1529,357
061604,gm. Ryki,lubelskie,16829,9642,9521,6298,3223
061605,gm. Stężyca,lubelskie,4428,2441,2383,1709,674
061606,gm. Ułęż,lubelskie,2787,1485,1458,1011,447
061701,m. Świdnik,lubelskie,32068,18957,18619,12007,6612
061702,gm. Mełgiew,lubelskie,7224,4043,3965,2940,1025
061703,gm. Piaski,lubelskie,8640,4304,4247,3133,1114
061704,gm. Rybczewice,lubelskie,2994,1484,1467,1194,273
061705,gm. Trawniki,lubelskie,7227,3360,3307,2380,927
061801,m. Tomaszów Lubelski,lubelskie,16251,8733,8608,5402,3206
061802,gm. Bełżec,lubelskie,2721,1231,1211,834,377
061803,gm. Jarczów,lubelskie,2937,1456,1443,1129,314
061804,gm. Krynice,lubelskie,2804,1442,1418,1072,346
061805,gm. Lubycza Królewska,lubelskie,5265,2015,1979,1248,731
061806,gm. Łaszczów,lubelskie,5228,2538,2501,1780,721
061807,gm. Rachanie,lubelskie,4487,2220,2192,1724,468
061808,gm. Susiec,lubelskie,6308,3159,3117,2399,718
061809,gm. Tarnawatka,lubelskie,3214,1635,1612,1280,332
061810,gm. Telatyn,lubelskie,3448,1588,1568,1156,412
061811,gm. Tomaszów Lubelski,lubelskie,9009,4512,4462,3355,1107
061812,gm. Tyszowce,lubelskie,4786,2253,2226,1708,518
061813,gm. Ulhówek,lubelskie,4173,1668,1641,1170,471
061901,m. Włodawa,lubelskie,11505,5824,5746,2903,2843
061902,gm. Hanna,lubelskie,2620,1251,1222,759,463
061903,gm. Hańsk,lubelskie,3054,1386,1370,857,513
061904,gm. Stary Brus,lubelskie,1763,912,894,560,334
061905,gm. Urszulin,lubelskie,3463,1833,1817,1278,539
061906,gm. Włodawa,lubelskie,4956,2434,2392,1345,1047
061907,gm. Wola Uhruska,lubelskie,3356,1581,1558,1037,521
061908,gm. Wyryki,lubelskie,2321,1084,1065,627,438
062001,gm. Adamów,lubelskie,3980,1999,1985,1583,402
062002,gm. Grabowiec,lubelskie,3623,1566,1556,1177,379
062003,gm. Komarów-Osada,lubelskie,4357,2476,2443,1694,749
062004,gm. Krasnobród,lubelskie,5897,3259,3230,2613,617
062005,gm. Łabunie,lubelskie,4966,2799,2780,2299,481
062006,gm. Miączyn,lubelskie,4895,2185,2167,1520,647
062007,gm. Nielisz,lubelskie,4791,2200,2180,1649,531
062008,gm. Radecznica,lubelskie,5177,2487,2469,2038,431
062009,gm. Sitno,lubelskie,5444,2853,2833,2249,584
062010,gm. Skierbieszów,lubelskie,4378,2228,2207,1697,510
062011,gm. Stary Zamość,lubelskie,4361,2401,2380,1760,620
062012,gm. Sułów,lubelskie,3953,1778,1762,1389,373
062013,gm. Szczebrzeszyn,lubelskie,9690,4604,4566,3416,1150
062014,gm. Zamość,lubelskie,17845,9640,9520,6762,2758
062015,gm. Zwierzyniec,lubelskie,5727,2698,2660,1728,932
066101,m. Biała Podlaska,lubelskie,45277,25477,25079,13439,11640
066201,m. Chełm,lubelskie,53187,27815,27389,15275,12114
066301,m. Lublin,lubelskie,270521,165794,163290,90730,72560
066401,m. Zamość,lubelskie,52743,28047,27685,16067,11618
080101,m. Kostrzyn nad Odrą,lubuskie,13680,6882,6783,2477,4306
080102,gm. Bogdaniec,lubuskie,5458,2574,2550,1168,1382
080103,gm. Deszczno,lubuskie,7067,3371,3323,1522,1801
080104,gm. Kłodawa,lubuskie,6305,3475,3427,1243,2184
080105,gm. Lubiszyn,lubuskie,5389,2398,2376,943,1433
080106,gm. Santok,lubuskie,6442,3044,2995,1214,1781
080107,gm. Witnica,lubuskie,10083,4544,4457,2003,2454
080201,m. Gubin,lubuskie,13203,5949,5860,1860,4000
080202,gm. Bobrowice,lubuskie,2587,1201,1190,569,621
080203,gm. Bytnica,lubuskie,2023,840,833,376,457
080204,gm. Dąbie,lubuskie,3926,1772,1750,729,1021
080205,gm. Gubin,lubuskie,5842,2389,2361,901,1460
080206,gm. Krosno Odrzańskie,lubuskie,14582,7082,6881,2784,4097
080207,gm. Maszewo,lubuskie,2342,960,952,429,523
080301,gm. Bledzew,lubuskie,3615,1706,1678,588,1090
080302,gm. Międzyrzecz,lubuskie,20504,10162,10001,3708,6293
080303,gm. Przytoczna,lubuskie,4576,2190,2144,814,1330
080304,gm. Pszczew,lubuskie,3489,1747,1736,698,1038
080305,gm. Skwierzyna,lubuskie,9917,4764,4699,1852,2847
080306,gm. Trzciel,lubuskie,5257,2373,2346,917,1429
080401,m. Nowa Sól,lubuskie,31321,15813,15592,6642,8950
080402,gm. Bytom Odrzański,lubuskie,4288,1903,1873,758,1115
080403,gm. Kolsko,lubuskie,2654,1192,1181,552,629
080404,gm. Kożuchów,lubuskie,12744,5785,5713,2355,3358
080405,gm. Nowa Sól,lubuskie,5469,2563,2532,1249,1283
080406,gm. Nowe Miasteczko,lubuskie,4381,2056,2026,977,1049
080407,gm. Otyń,lubuskie,5253,2511,2472,1139,1333
080408,gm. Siedlisko,lubuskie,2758,1127,1120,512,608
080501,gm. Cybinka,lubuskie,5103,2242,2220,981,1239
080502,gm. Górzyca,lubuskie,3296,1439,1417,643,774
080503,gm. Ośno Lubuskie,lubuskie,5132,2341,2303,807,1496
080504,gm. Rzepin,lubuskie,7745,3616,3587,1478,2109
080505,gm. Słubice,lubuskie,15436,7785,7695,2433,5262
080601,gm. Dobiegniew,lubuskie,5491,2370,2331,958,1373
080602,gm. Drezdenko,lubuskie,13868,6726,6659,2952,3707
080603,gm. Stare Kurowo,lubuskie,3337,1453,1436,612,824
080604,gm. Strzelce Krajeńskie,lubuskie,13741,6110,6037,2067,3970
080605,gm. Zwierzyn,lubuskie,3488,1537,1518,675,843
080701,gm. Krzeszyce,lubuskie,3729,1726,1700,752,948
080702,gm. Lubniewice,lubuskie,2582,1245,1229,461,768
080703,gm. Słońsk,lubuskie,4165,1930,1900,827,1073
080704,gm. Sulęcin,lubuskie,13162,6563,6456,3106,3350
080705,gm. Torzym,lubuskie,5589,2386,2352,857,1495
080801,gm. Lubrza,lubuskie,2817,1314,1296,536,760
080802,gm. Łagów,lubuskie,4299,1929,1904,737,1167
080803,gm. Skąpe,lubuskie,4110,1853,1825,710,1115
080804,gm. Szczaniec,lubuskie,3078,1463,1445,733,712
080805,gm. Świebodzin,lubuskie,23332,11824,11667,4781,6886
080806,gm. Zbąszynek,lubuskie,6631,3642,3592,1200,2392
080901,gm. Babimost,lubuskie,4970,2535,2495,859,1636
080902,gm. Bojadła,lubuskie,2676,1228,1193,434,759
080903,gm. Czerwieńsk,lubuskie,7654,3618,3555,1360,2195
080904,gm. Kargowa,lubuskie,4635,2191,2168,701,1467
080905,gm. Nowogród Bobrzański,lubuskie,8143,3818,3748,1277,2471
080906,gm. Sulechów,lubuskie,20674,10216,10012,3882,6130
080907,gm. Świdnica,lubuskie,5063,2695,2662,890,1772
080908,gm. Trzebiechów,lubuskie,2627,1104,1077,413,664
080909,gm. Zabór,lubuskie,3151,1651,1630,551,1079
081001,m. Gozdnica,lubuskie,2659,1029,1007,465,542
081002,m. Żagań,lubuskie,20776,10636,10456,4040,6416
081003,gm. Brzeźnica,lubuskie,2981,1413,1391,703,688
081004,gm. Iłowa,lubuskie,5686,2506,2464,1063,1401
081005,gm. Małomice,lubuskie,4319,1864,1830,762,1068
081006,gm. Niegosławice,lubuskie,3589,1592,1560,914,646
081007,gm. Szprotawa,lubuskie,16871,7376,7271,3040,4231
081008,gm. Wymiarki,lubuskie,1906,764,756,370,386
081009,gm. Żagań,lubuskie,5966,2668,2593,1213,1380
081101,m. Łęknica,lubuskie,1976,851,838,300,538
081102,m. Żary,lubuskie,30320,15192,14982,6062,8920
081103,gm. Brody,lubuskie,2753,1105,1087,447,640
081104,gm. Jasień,lubuskie,5716,2314,2285,910,1375
081105,gm. Lipinki Łużyckie,lubuskie,2587,1084,1071,489,582
081106,gm. Lubsko,lubuskie,15227,6598,6494,2550,3944
081107,gm. Przewóz,lubuskie,2556,1115,1075,529,546
081108,gm. Trzebiel,lubuskie,4598,1990,1966,877,1089
081109,gm. Tuplice,lubuskie,2567,1015,1000,355,645
081110,gm. Żary,lubuskie,9568,4140,4098,1934,2164
081201,gm. Sława,lubuskie,9940,4676,4610,1982,2628
081202,gm. Szlichtyngowa,lubuskie,3972,1930,1912,1004,908
081203,gm. Wschowa,lubuskie,17006,8474,8361,3814,4547
086101,m. Gorzów Wielkopolski,lubuskie,96895,50680,49954,20363,29591
086201,m. Zielona Góra,lubuskie,106694,62158,61224,21643,39581
100101,m. Bełchatów,łódzkie,47814,28910,28385,19231,9154
100102,gm. Bełchatów,łódzkie,8663,5411,5333,4193,1140
100103,gm. Drużbice,łódzkie,4204,2353,2320,1699,621
100104,gm. Kleszczów,łódzkie,4136,2524,2484,1922,562
100105,gm. Kluki,łódzkie,3487,1984,1960,1534,426
100106,gm. Rusiec,łódzkie,4254,2553,2526,1830,696
100107,gm. Szczerców,łódzkie,6479,3895,3848,2908,940
100108,gm. Zelów,łódzkie,12097,6728,6618,4838,1780
100201,m. Kutno,łódzkie,37374,20855,20551,11007,9544
100202,gm. Bedlno,łódzkie,4690,2201,2178,1410,768
100203,gm. Dąbrowice,łódzkie,1638,801,786,576,210
100204,gm. Krośniewice,łódzkie,7107,3360,3316,2080,1236
100205,gm. Krzyżanów,łódzkie,3547,1740,1727,1159,568
100206,gm. Kutno,łódzkie,7001,3694,3634,2359,1275
100207,gm. Łanięta,łódzkie,1949,861,851,603,248
100208,gm. Nowe Ostrowy,łódzkie,2965,1339,1330,844,486
100209,gm. Oporów,łódzkie,2224,1144,1127,805,322
100210,gm. Strzelce,łódzkie,3295,1667,1646,1129,517
100211,gm. Żychlin,łódzkie,10267,4794,4727,2717,2010
100301,gm. Buczek,łódzkie,4148,2199,2181,1452,729
100302,gm. Łask,łódzkie,23050,12483,12242,6555,5687
100303,gm. Sędziejowice,łódzkie,5219,2884,2853,1931,922
100304,gm. Widawa,łódzkie,6419,3362,3329,2303,1026
100305,gm. Wodzierady,łódzkie,2730,1554,1534,875,659
100401,m. Łęczyca,łódzkie,11992,6461,6359,2834,3525
100402,gm. Daszyna,łódzkie,3343,1435,1409,968,441
100403,gm. Góra Świętej Małgorzaty,łódzkie,3615,1786,1774,1312,462
100404,gm. Grabów,łódzkie,5139,2449,2419,1630,789
100405,gm. Łęczyca,łódzkie,7938,3831,3780,2348,1432
100406,gm. Piątek,łódzkie,5091,2627,2599,1853,746
100407,gm. Świnice Warckie,łódzkie,3279,1620,1598,1017,581
100408,gm. Witonia,łódzkie,2777,1352,1334,918,416
100501,m. Łowicz,łódzkie,24216,13990,13745,7154,6591
100502,gm. Bielawy,łódzkie,4731,2417,2381,1524,857
100503,gm. Chąśno,łódzkie,2471,1281,1264,905,359
100504,gm. Domaniewice,łódzkie,3739,1941,1917,1366,551
100505,gm. Kiernozia,łódzkie,2892,1420,1405,968,437
100506,gm. Kocierzew Południowy,łódzkie,3531,1983,1939,1549,390
100507,gm. Łowicz,łódzkie,6110,3355,3307,2236,1071
100508,gm. Łyszkowice,łódzkie,5407,2692,2654,1914,740
100509,gm. Nieborów,łódzkie,7669,4470,4414,2956,1458
100510,gm. Zduny,łódzkie,4876,2487,2442,1530,912
100602,gm. Andrespol,łódzkie,10436,6593,6502,3266,3236
100603,gm. Brójce,łódzkie,4988,3207,3168,2037,1131
100607,gm. Koluszki,łódzkie,18906,11540,11375,6406,4969
100608,gm. Nowosolna,łódzkie,3646,2372,2334,1024,1310
100610,gm. Rzgów,łódzkie,7741,4976,4888,2862,2026
100611,gm. Tuszyn,łódzkie,10081,5708,5642,3167,2475
100701,gm. Białaczów,łódzkie,4781,2543,2509,1837,672
100702,gm. Drzewica,łódzkie,8788,5285,5206,3939,1267
100703,gm. Mniszków,łódzkie,3793,2176,2141,1703,438
100704,gm. Opoczno,łódzkie,27786,16942,16678,11504,5174
100705,gm. Paradyż,łódzkie,3544,2121,2079,1791,288
100706,gm. Poświętne,łódzkie,2791,1669,1653,1280,373
100707,gm. Sławno,łódzkie,5966,3594,3553,2823,730
100708,gm. Żarnów,łódzkie,5150,2817,2785,2170,615
100801,m. Konstantynów Łódzki,łódzkie,14504,8650,8497,3982,4515
100802,m. Pabianice,łódzkie,54631,31744,31243,14003,17240
100803,gm. Dłutów,łódzkie,3547,2057,2030,1284,746
100804,gm. Dobroń,łódzkie,6016,3483,3406,1833,1573
100805,gm. Ksawerów,łódzkie,6110,3793,3732,1740,1992
100806,gm. Lutomiersk,łódzkie,6374,3617,3576,1908,1668
100807,gm. Pabianice,łódzkie,5259,3322,3283,1866,1417
100901,gm. Działoszyn,łódzkie,10206,5375,5278,3172,2106
100902,gm. Kiełczygłów,łódzkie,3491,1919,1900,1481,419
100903,gm. Nowa Brzeźnica,łódzkie,3924,2022,1977,1407,570
100904,gm. Pajęczno,łódzkie,9591,5061,4984,3305,1679
100905,gm. Rząśnia,łódzkie,3890,2248,2228,1771,457
100906,gm. Siemkowice,łódzkie,4007,2001,1971,1390,581
100907,gm. Strzelce Wielkie,łódzkie,3857,2083,2045,1529,516
100908,gm. Sulmierzyce,łódzkie,3687,2231,2205,1677,528
101001,gm. Aleksandrów,łódzkie,3761,2103,2080,1560,520
101002,gm. Czarnocin,łódzkie,3279,1937,1915,1406,509
101003,gm. Gorzkowice,łódzkie,6855,3889,3839,3082,757
101004,gm. Grabica,łódzkie,4812,2714,2687,2022,665
101005,gm. Łęki Szlacheckie,łódzkie,2945,1449,1419,1073,346
101006,gm. Moszczenica,łódzkie,10225,5926,5803,4259,1544
101007,gm. Ręczno,łódzkie,3062,1629,1601,1120,481
101008,gm. Rozprza,łódzkie,9607,5362,5274,4011,1263
101009,gm. Sulejów,łódzkie,13096,7505,7399,5052,2347
101010,gm. Wola Krzysztoporska,łódzkie,9247,5450,5414,4447,967
101011,gm. Wolbórz,łódzkie,6289,3873,3811,2575,1236
101101,gm. Dalików,łódzkie,3132,1620,1596,951,645
101102,gm. Pęczniew,łódzkie,3000,1643,1627,1028,599
101103,gm. Poddębice,łódzkie,12962,6730,6632,3682,2950
101104,gm. Uniejów,łódzkie,6126,3215,3177,2006,1171
101105,gm. Wartkowice,łódzkie,5143,2427,2391,1512,879
101106,gm. Zadzim,łódzkie,4310,2300,2255,1374,881
101201,m. Radomsko,łódzkie,38453,21233,20916,11321,9595
101202,gm. Dobryszyce,łódzkie,3366,1760,1722,1129,593
101203,gm. Gidle,łódzkie,5283,2605,2584,1676,908
101204,gm. Gomunice,łódzkie,4757,2766,2731,1955,776
101205,gm. Kamieńsk,łódzkie,4891,2959,2935,2325,610
101206,gm. Kobiele Wielkie,łódzkie,3583,1769,1742,1117,625
101207,gm. Kodrąb,łódzkie,3854,1925,1909,1262,647
101208,gm. Lgota Wielka,łódzkie,3517,1978,1944,1397,547
101209,gm. Ładzice,łódzkie,3910,1883,1865,1165,700
101210,gm. Masłowice,łódzkie,3561,1774,1756,1236,520
101211,gm. Przedbórz,łódzkie,6197,3205,3164,2240,924
101212,gm. Radomsko,łódzkie,4495,2333,2298,1515,783
101213,gm. Wielgomłyny,łódzkie,3922,1907,1879,1326,553
101214,gm. Żytno,łódzkie,4521,2106,2080,1492,588
101301,m. Rawa Mazowiecka,łódzkie,14334,8194,8062,4558,3504
101302,gm. Biała Rawska,łódzkie,9291,4650,4599,3094,1505
101303,gm. Cielądz,łódzkie,3289,1703,1683,1278,405
101304,gm. Rawa Mazowiecka,łódzkie,6900,3572,3534,2574,960
101305,gm. Regnów,łódzkie,1510,753,745,555,190
101306,gm. Sadkowice,łódzkie,4542,2303,2275,1645,630
101401,m. Sieradz,łódzkie,35963,20466,20131,10000,10131
101402,gm. Błaszki,łódzkie,12012,5881,5785,3549,2236
101403,gm. Brąszewice,łódzkie,3526,1950,1936,1481,455
101404,gm. Brzeźnio,łódzkie,5042,2687,2641,1664,977
101405,gm. Burzenin,łódzkie,4500,2213,2184,1349,835
101406,gm. Goszczanów,łódzkie,4459,2118,2085,1367,718
101407,gm. Klonowa,łódzkie,2362,1141,1125,715,410
101408,gm. Sieradz,łódzkie,8098,4586,4531,3020,1511
101409,gm. Warta,łódzkie,10495,5343,5285,3597,1688
101410,gm. Wróblew,łódzkie,4903,2583,2554,1776,778
101411,gm. Złoczew,łódzkie,5865,3040,2981,2015,966
101501,gm. Bolimów,łódzkie,3232,1735,1706,1092,614
101502,gm. Głuchów,łódzkie,4684,3067,3035,2490,545
101503,gm. Godzianów,łódzkie,2081,1254,1238,983,255
101504,gm. Kowiesy,łódzkie,2462,1307,1289,829,460
101505,gm. Lipce Reymontowskie,łódzkie,2661,1506,1490,1111,379
101506,gm. Maków,łódzkie,4839,2742,2699,1921,778
101507,gm. Nowy Kawęczyn,łódzkie,2812,1505,1483,1043,440
101508,gm. Skierniewice,łódzkie,5811,3078,3049,2130,919
101509,gm. Słupia,łódzkie,2121,1223,1206,933,273
101601,m. Tomaszów Mazowiecki,łódzkie,51055,29231,28800,14235,14565
101602,gm. Będków,łódzkie,2786,1575,1548,1154,394
101603,gm. Budziszewice,łódzkie,1806,1047,1027,723,304
101604,gm. Czerniewice,łódzkie,4208,2178,2156,1573,583
101605,gm. Inowłódz,łódzkie,3269,1905,1878,1066,812
101606,gm. Lubochnia,łódzkie,5488,3320,3278,2388,890
101607,gm. Rokiciny,łódzkie,5082,2798,2745,1742,1003
101608,gm. Rzeczyca,łódzkie,3952,2245,2214,1682,532
101609,gm. Tomaszów Mazowiecki,łódzkie,8522,5043,4974,3196,1778
101610,gm. Ujazd,łódzkie,6340,3473,3415,2254,1161
101611,gm. Żelechlinek,łódzkie,2702,1541,1516,1114,402
101701,gm. Biała,łódzkie,4447,2308,2289,1448,841
101702,gm. Czarnożyły,łódzkie,3631,1908,1891,1215,676
101703,gm. Konopnica,łódzkie,3236,1773,1750,995,755
101704,gm. Mokrsko,łódzkie,4361,2431,2392,1452,940
101705,gm. Osjaków,łódzkie,3850,2153,2126,1483,643
101706,gm. Ostrówek,łódzkie,3616,1844,1808,1151,657
101707,gm. Pątnów,łódzkie,5218,2826,2806,2070,736
101708,gm. Skomlin,łódzkie,2688,1335,1315,749,566
101709,gm. Wieluń,łódzkie,26210,14379,14149,6903,7246
101710,gm. Wierzchlas,łódzkie,5401,2704,2668,1628,1040
101801,gm. Bolesławiec,łódzkie,3363,1763,1729,984,745
101802,gm. Czastary,łódzkie,3176,1502,1480,973,507
101803,gm. Galewice,łódzkie,5000,2464,2432,1435,997
101804,gm. Lututów,łódzkie,3702,1931,1898,1202,696
101805,gm. Łubnice,łódzkie,3354,1668,1632,919,713
101806,gm. Sokolniki,łódzkie,3946,1960,1928,1205,723
101807,gm. Wieruszów,łódzkie,11452,6326,6241,3121,3120
101901,m. Zduńska Wola,łódzkie,34566,19527,19214,9769,9445
101902,gm. Szadek,łódzkie,6072,3080,3044,1928,1116
101903,gm. Zapolice,łódzkie,4120,2208,2182,1306,876
101904,gm. Zduńska Wola,łódzkie,9300,5093,5027,3175,1852
102001,m. Głowno,łódzkie,12097,6633,6534,3083,3451
102002,m. Ozorków,łódzkie,16061,8497,8371,4266,4105
102003,m. Zgierz,łódzkie,46596,26951,26506,11992,14514
102004,gm. Aleksandrów Łódzki,łódzkie,23858,14492,14229,6534,7695
102005,gm. Głowno,łódzkie,3941,2041,2008,1391,617
102006,gm. Ozorków,łódzkie,5819,3406,3362,2036,1326
102007,gm. Parzęczew,łódzkie,4081,2229,2187,1243,944
102008,gm. Stryków,łódzkie,10035,5867,5801,2951,2850
102009,gm. Zgierz,łódzkie,10901,6764,6690,3550,3140
102101,m. Brzeziny,łódzkie,10252,5758,5662,3118,2544
102102,gm. Brzeziny,łódzkie,4379,2524,2479,1562,917
102103,gm. Dmosin,łódzkie,3755,2023,1991,1255,736
102104,gm. Jeżów,łódzkie,2792,1726,1697,1124,573
102105,gm. Rogów,łódzkie,3898,2254,2218,1415,803
106101,m. Łódź,łódzkie,562835,335514,330291,128818,201473
106201,m. Piotrków Trybunalski,łódzkie,60371,35201,34605,18256,16349
106301,m. Skierniewice,łódzkie,38644,23019,22631,11309,11322
120101,m. Bochnia,małopolskie,23449,14058,13870,8295,5575
120102,gm. Bochnia,małopolskie,15251,9042,8949,6537,2412
120103,gm. Drwinia,małopolskie,5116,3065,3030,2457,573
120104,gm. Lipnica Murowana,małopolskie,4376,2548,2528,1953,575
120105,gm. Łapanów,małopolskie,6138,3568,3527,2612,915
120106,gm. Nowy Wiśnicz,małopolskie,10766,6844,6784,5078,1706
120107,gm. Rzezawa,małopolskie,8597,5068,5027,3980,1047
120108,gm. Trzciana,małopolskie,4191,2806,2778,2216,562
120109,gm. Żegocina,małopolskie,4069,2864,2842,2452,390
120201,gm. Borzęcin,małopolskie,6682,3473,3434,2533,901
120202,gm. Brzesko,małopolskie,29174,16397,16198,10646,5552
120203,gm. Czchów,małopolskie,7528,4330,4285,3172,1113
120204,gm. Dębno,małopolskie,11281,6604,6510,4756,1754
120205,gm. Gnojnik,małopolskie,5975,3507,3471,2726,745
120206,gm. Iwkowa,małopolskie,4807,3002,2979,2429,550
120207,gm. Szczurowa,małopolskie,7721,3621,3588,2578,1010
120301,gm. Alwernia,małopolskie,10336,5928,5836,3526,2310
120302,gm. Babice,małopolskie,7372,4299,4235,2598,1637
120303,gm. Chrzanów,małopolskie,38602,21579,21245,9832,11413
120304,gm. Libiąż,małopolskie,18116,10386,10256,5878,4378
120305,gm. Trzebinia,małopolskie,27724,15622,15363,7626,7737
120401,gm. Bolesław,małopolskie,2336,933,921,734,187
120402,gm. Dąbrowa Tarnowska,małopolskie,17020,8689,8603,6621,1982
120403,gm. Gręboszów,małopolskie,2897,1353,1338,1013,325
120404,gm. Mędrzechów,małopolskie,2848,1352,1335,1004,331
120405,gm. Olesno,małopolskie,6252,3146,3117,2602,515
120406,gm. Radgoszcz,małopolskie,5764,3098,3064,2658,406
120407,gm. Szczucin,małopolskie,10635,5189,5132,3795,1337
120501,m. Gorlice,małopolskie,23288,12476,12319,7183,5136
120502,gm. Biecz,małopolskie,13650,7269,7195,5210,1985
120503,gm. Bobowa,małopolskie,7222,4208,4181,3272,909
120504,gm. Gorlice,małopolskie,13579,7442,7353,5255,2098
120505,gm. Lipinki,małopolskie,5453,3028,3005,2295,710
120506,gm. Łużna,małopolskie,6563,3576,3519,2496,1023
120507,gm. Moszczenica,małopolskie,3800,1968,1952,1597,355
120508,gm. Ropa,małopolskie,4023,2373,2356,1861,495
120509,gm. Sękowa,małopolskie,4021,2085,2067,1279,788
120510,gm. Uście Gorlickie,małopolskie,5444,2773,2736,1435,1301
120601,gm. Czernichów,małopolskie,11099,6426,6332,4188,2144
120602,gm. Igołomia-Wawrzeńczyce,małopolskie,6135,2855,2831,1915,916
120603,gm. Iwanowice,małopolskie,7057,4014,3970,2802,1168
120604,gm. Jerzmanowice-Przeginia,małopolskie,8671,5245,5177,3652,1525
120605,gm. Kocmyrzów-Luborzyca,małopolskie,11286,6432,6349,4152,2197
120606,gm. Krzeszowice,małopolskie,26198,15151,14929,8434,6495
120607,gm. Liszki,małopolskie,13019,7917,7838,5369,2469
120608,gm. Michałowice,małopolskie,7420,4582,4546,2630,1916
120609,gm. Mogilany,małopolskie,10153,6505,6417,3765,2652
120610,gm. Skała,małopolskie,8242,4757,4697,3047,1650
120611,gm. Skawina,małopolskie,33615,19716,19396,11755,7641
120612,gm. Słomniki,małopolskie,10920,6006,5943,4208,1735
120613,gm. Sułoszowa,małopolskie,4638,2909,2873,2208,665
120614,gm. Świątniki Górne,małopolskie,7641,4517,4460,2917,1543
120615,gm. Wielka Wieś,małopolskie,8613,5491,5424,3136,2288
120616,gm. Zabierzów,małopolskie,20092,13179,12966,6952,6014
120617,gm. Zielonki,małopolskie,15309,9985,9819,4911,4908
120701,m. Limanowa,małopolskie,12100,7503,7407,5191,2216
120702,m. Mszana Dolna,małopolskie,6094,3567,3524,2460,1064
120703,gm. Dobra,małopolskie,7587,4106,4070,3060,1010
120704,gm. Jodłownik,małopolskie,6541,3614,3575,2801,774
120705,gm. Kamienica,małopolskie,5798,3367,3342,2750,592
120706,gm. Laskowa,małopolskie,5832,3993,3960,3584,376
120707,gm. Limanowa,małopolskie,18526,11619,11539,9548,1991
120708,gm. Łukowica,małopolskie,7201,4489,4418,3586,832
120709,gm. Mszana Dolna,małopolskie,13008,7535,7491,6295,1196
120710,gm. Niedźwiedź,małopolskie,5378,2701,2677,2166,511
120711,gm. Słopnice,małopolskie,4521,2802,2780,2421,359
120712,gm. Tymbark,małopolskie,4893,3226,3189,2628,561
120801,gm. Charsznica,małopolskie,6219,3140,3106,2259,847
120802,gm. Gołcza,małopolskie,5092,2780,2754,2011,743
120803,gm. Kozłów,małopolskie,3977,1899,1880,1455,425
120804,gm. Książ Wielki,małopolskie,4358,2264,2238,1687,551
120805,gm. Miechów,małopolskie,16099,8691,8564,5426,3138
120806,gm. Racławice,małopolskie,2076,865,857,615,242
120807,gm. Słaboszów,małopolskie,3062,1319,1316,922,394
120901,gm. Dobczyce,małopolskie,11596,6990,6888,4852,2036
120902,gm. Lubień,małopolskie,7615,4507,4441,3560,881
120903,gm. Myślenice,małopolskie,33706,21061,20810,13936,6874
120904,gm. Pcim,małopolskie,8392,5363,5289,4178,1111
120905,gm. Raciechowice,małopolskie,4985,2689,2660,2015,645
120906,gm. Siepraw,małopolskie,6640,4036,3990,2885,1105
120907,gm. Sułkowice,małopolskie,11360,6452,6372,4552,1820
120908,gm. Tokarnia,małopolskie,6544,4057,3981,3160,821
120909,gm. Wiśniowa,małopolskie,5530,3421,3390,2692,698
121001,m. Grybów,małopolskie,4800,3087,3050,2364,686
121002,gm. Chełmiec,małopolskie,20559,13215,13076,10440,2636
121003,gm. Gródek nad Dunajcem,małopolskie,6913,3992,3953,3122,831
121004,gm. Grybów,małopolskie,18229,12194,12120,10443,1677
121005,gm. Kamionka Wielka,małopolskie,7472,4877,4816,3983,833
121006,gm. Korzenna,małopolskie,10706,6634,6579,5601,978
121007,gm. Krynica-Zdrój,małopolskie,14950,8743,8651,5180,3471
121008,gm. Łabowa,małopolskie,4182,2540,2513,2063,450
121009,gm. Łącko,małopolskie,12087,7352,7267,5886,1381
121010,gm. Łososina Dolna,małopolskie,7961,5235,5198,4523,675
121011,gm. Muszyna,małopolskie,9236,5249,5197,3513,1684
121012,gm. Nawojowa,małopolskie,6173,3830,3798,3105,693
121013,gm. Piwniczna-Zdrój,małopolskie,8450,4606,4539,3512,1027
121014,gm. Podegrodzie,małopolskie,9336,5915,5833,4850,983
121015,gm. Rytro,małopolskie,2979,1761,1734,1428,306
121016,gm. Stary Sącz,małopolskie,17857,10987,10915,8589,2326
121101,m. Nowy Targ,małopolskie,26751,14408,14228,8154,6074
121102,gm. Szczawnica,małopolskie,6349,3332,3288,1779,1509
121103,gm. Czarny Dunajec,małopolskie,17174,7569,7494,5860,1634
121104,gm. Czorsztyn,małopolskie,5886,2939,2913,1831,1082
121105,gm. Jabłonka,małopolskie,13815,7853,7653,6529,1124
121106,gm. Krościenko nad Dunajcem,małopolskie,5595,3119,3083,2136,947
121107,gm. Lipnica Wielka,małopolskie,4459,2534,2511,2032,479
121108,gm. Łapsze Niżne,małopolskie,7150,3521,3487,2417,1070
121109,gm. Nowy Targ,małopolskie,18116,9377,9255,6680,2575
121110,gm. Ochotnica Dolna,małopolskie,6365,3630,3608,2980,628
121111,gm. Raba Wyżna,małopolskie,11122,5878,5820,4364,1456
121112,gm. Rabka-Zdrój,małopolskie,14126,8252,8150,5715,2435
121113,gm. Spytkowice,małopolskie,3353,1746,1724,1370,354
121114,gm. Szaflary,małopolskie,8271,3601,3581,2919,662
121201,m. Bukowno,małopolskie,8536,4642,4548,2391,2157
121203,gm. Bolesław,małopolskie,6573,3417,3364,1713,1651
121204,gm. Klucze,małopolskie,12546,7113,6983,3686,3297
121205,gm. Olkusz,małopolskie,39971,23605,23207,13701,9506
121206,gm. Trzyciąż,małopolskie,5678,3174,3138,2453,685
121207,gm. Wolbrom,małopolskie,18817,10540,10425,7243,3182
121301,m. Oświęcim,małopolskie,31811,18535,18304,8514,9790
121302,gm. Brzeszcze,małopolskie,17282,10495,10333,5997,4336
121303,gm. Chełmek,małopolskie,10363,6000,5933,3182,2751
121304,gm. Kęty,małopolskie,26887,15988,15773,9040,6733
121305,gm. Osiek,małopolskie,6467,3702,3661,2376,1285
121306,gm. Oświęcim,małopolskie,14488,9053,8915,5088,3827
121307,gm. Polanka Wielka,małopolskie,3402,2046,1998,1232,766
121308,gm. Przeciszów,małopolskie,5446,3085,2991,1786,1205
121309,gm. Zator,małopolskie,7522,4490,4404,2580,1824
121401,gm. Koniusza,małopolskie,6999,3474,3433,2434,999
121402,gm. Koszyce,małopolskie,4656,2024,1997,1382,615
121403,gm. Nowe Brzesko,małopolskie,4677,2509,2446,1730,716
121404,gm. Pałecznica,małopolskie,2897,1368,1354,973,381
121405,gm. Proszowice,małopolskie,13468,6773,6701,4369,2332
121406,gm. Radziemice,małopolskie,2783,1365,1347,976,371
121501,m. Jordanów,małopolskie,4171,2421,2383,1462,921
121502,m. Sucha Beskidzka,małopolskie,7953,4390,4348,2426,1922
121503,gm. Budzów,małopolskie,6657,3581,3544,2594,950
121504,gm. Bystra-Sidzina,małopolskie,5156,2705,2604,2006,598
121505,gm. Jordanów,małopolskie,8385,4768,4718,3665,1053
121506,gm. Maków Podhalański,małopolskie,12941,7477,7423,5213,2210
121507,gm. Stryszawa,małopolskie,9531,5633,5554,3895,1659
121508,gm. Zawoja,małopolskie,7282,4014,3968,2630,1338
121509,gm. Zembrzyce,małopolskie,4456,2568,2549,1626,923
121601,gm. Ciężkowice,małopolskie,8894,4828,4790,3475,1315
121602,gm. Gromnik,małopolskie,6760,3760,3730,3125,605
121603,gm. Lisia Góra,małopolskie,11326,6527,6460,5090,1370
121604,gm. Pleśna,małopolskie,9353,5194,5134,3782,1352
121605,gm. Radłów,małopolskie,7836,4072,4015,3056,959
121606,gm. Ryglice,małopolskie,9141,4925,4870,3815,1055
121607,gm. Rzepiennik Strzyżewski,małopolskie,5371,3105,3079,2456,623
121608,gm. Skrzyszów,małopolskie,10847,6273,6190,4662,1528
121609,gm. Tarnów,małopolskie,19538,11655,11529,8172,3357
121610,gm. Tuchów,małopolskie,14136,8073,8023,6150,1873
121611,gm. Wierzchosławice,małopolskie,8482,5091,5025,3594,1431
121612,gm. Wietrzychowice,małopolskie,3258,1523,1490,986,504
121613,gm. Wojnicz,małopolskie,10450,5868,5800,4350,1450
121614,gm. Zakliczyn,małopolskie,9628,5312,5255,3903,1352
121615,gm. Żabno,małopolskie,15077,7909,7835,5814,2021
121616,gm. Szerzyny,małopolskie,6354,3571,3535,2817,718
121701,m. Zakopane,małopolskie,23691,14101,13947,7527,6420
121702,gm. Biały Dunajec,małopolskie,5537,2758,2737,2248,489
121703,gm. Bukowina Tatrzańska,małopolskie,10229,5442,5391,4221,1170
121704,gm. Kościelisko,małopolskie,6695,3400,3370,2303,1067
121705,gm. Poronin,małopolskie,8893,4609,4571,3260,1311
121801,gm. Andrychów,małopolskie,34757,20773,20453,12347,8106
121802,gm. Brzeźnica,małopolskie,7967,4333,4256,2627,1629
121803,gm. Kalwaria Zebrzydowska,małopolskie,15722,9191,9003,5436,3567
121804,gm. Lanckorona,małopolskie,4757,2454,2358,1467,891
121805,gm. Mucharz,małopolskie,3162,1879,1863,1119,744
121806,gm. Spytkowice,małopolskie,8075,4509,4467,2958,1509
121807,gm. Stryszów,małopolskie,5379,2953,2907,1800,1107
121808,gm. Tomice,małopolskie,5989,3343,3310,1910,1400
121809,gm. Wadowice,małopolskie,30526,17560,17331,9450,7881
121810,gm. Wieprz,małopolskie,9312,5620,5552,3677,1875
121901,gm. Biskupice,małopolskie,7444,4548,4497,3197,1300
121902,gm. Gdów,małopolskie,13541,7927,7819,5480,2339
121903,gm. Kłaj,małopolskie,8340,4893,4842,2859,1983
121904,gm. Niepołomice,małopolskie,20186,12083,11935,7096,4839
121905,gm. Wieliczka,małopolskie,42831,25851,25516,14285,11231
126101,m. Kraków,małopolskie,596651,378687,373236,176990,196246
126201,m. Nowy Sącz,małopolskie,65657,40375,39910,24916,14994
126301,m. Tarnów,małopolskie,91528,51330,50470,28025,22445
140101,gm. Białobrzegi,mazowieckie,8471,4939,4878,3048,1830
140102,gm. Promna,mazowieckie,4574,2494,2467,1710,757
140103,gm. Radzanów,mazowieckie,3052,1692,1676,1350,326
140104,gm. Stara Błotnica,mazowieckie,4129,2378,2350,1932,418
140105,gm. Stromiec,mazowieckie,4448,2322,2273,1818,455
140106,gm. Wyśmierzyce,mazowieckie,2420,1394,1381,1160,221
140201,m. Ciechanów,mazowieckie,36421,19855,19585,10405,9180
140202,gm. Ciechanów,mazowieckie,5445,2573,2540,1475,1065
140203,gm. Glinojeck,mazowieckie,6367,2854,2808,1683,1125
140204,gm. Gołymin-Ośrodek,mazowieckie,3188,1548,1536,1186,350
140205,gm. Grudusk,mazowieckie,3018,1548,1516,1103,413
140206,gm. Ojrzeń,mazowieckie,3464,1720,1705,1192,513
140207,gm. Opinogóra Górna,mazowieckie,4769,2320,2277,1613,664
140208,gm. Regimin,mazowieckie,4045,1935,1916,1227,689
140209,gm. Sońsk,mazowieckie,6339,3179,3120,2088,1032
140301,m. Garwolin,mazowieckie,13330,8795,8657,5563,3094
140302,m. Łaskarzew,mazowieckie,3907,2393,2363,1642,721
140303,gm. Borowie,mazowieckie,4143,2468,2437,1917,520
140304,gm. Garwolin,mazowieckie,9825,6088,6015,4387,1628
140305,gm. Górzno,mazowieckie,5032,3222,3190,2616,574
140306,gm. Łaskarzew,mazowieckie,4300,2681,2652,2034,618
140307,gm. Maciejowice,mazowieckie,5858,3345,3324,2643,681
140308,gm. Miastków Kościelny,mazowieckie,3949,2406,2376,1832,544
140309,gm. Parysów,mazowieckie,3274,1844,1829,1547,282
140310,gm. Pilawa,mazowieckie,8402,5041,4959,3654,1305
140311,gm. Sobolew,mazowieckie,6405,3976,3935,3200,735
140312,gm. Trojanów,mazowieckie,5971,3624,3588,2963,625
140313,gm. Wilga,mazowieckie,4440,2535,2504,1550,954
140314,gm. Żelechów,mazowieckie,6658,4076,4022,3186,836
140401,m. Gostynin,mazowieckie,15533,8221,8084,4556,3528
140402,gm. Gostynin,mazowieckie,9945,5005,4945,3368,1577
140403,gm. Pacyna,mazowieckie,3105,1507,1491,1119,372
140404,gm. Sanniki,mazowieckie,5126,2534,2490,1808,682
140405,gm. Szczawin Kośc.,mazowieckie,4134,1958,1928,1354,574
140501,m. Milanówek,mazowieckie,12950,8777,8666,3846,4820
140502,m. Podkowa Leśna,mazowieckie,3229,2385,2344,884,1460
140503,gm. Baranów,mazowieckie,4017,2199,2172,1420,752
140504,gm. Grodzisk Mazowiecki,mazowieckie,33763,21720,21408,9923,11485
140505,gm. Jaktorów,mazowieckie,9092,5603,5504,2935,2569
140506,gm. Żabia Wola,mazowieckie,6354,3838,3789,2026,1763
140601,gm. Belsk Duży,mazowieckie,5345,3078,3030,1902,1128
140602,gm. Błędów,mazowieckie,6266,3475,3436,2305,1131
140603,gm. Chynów,mazowieckie,7920,4480,4381,2728,1653
140604,gm. Goszczyn,mazowieckie,2350,1425,1412,1093,319
140605,gm. Grójec,mazowieckie,19979,11637,11471,5774,5697
140606,gm. Jasieniec,mazowieckie,4296,2312,2284,1514,770
140607,gm. Mogielnica,mazowieckie,7400,4144,4094,2910,1184
140608,gm. Nowe Miasto nad Pilicą,mazowieckie,6900,4142,4092,2895,1197
140609,gm. Pniewy,mazowieckie,3823,2193,2168,1371,797
140611,gm. Warka,mazowieckie,15341,9119,8997,5770,3227
140701,gm. Garbatka-Letnisko,mazowieckie,4795,2672,2606,1766,840
140702,gm. Głowaczów,mazowieckie,6142,3445,3419,2762,657
140703,gm. Gniewoszów,mazowieckie,3353,1803,1784,1295,489
140704,gm. Grabów nad Pilicą,mazowieckie,3170,1820,1810,1417,393
140705,gm. Kozienice,mazowieckie,24704,14094,13872,9358,4514
140706,gm. Magnuszew,mazowieckie,5694,3275,3240,2389,851
140707,gm. Sieciechów,mazowieckie,3311,1697,1667,1230,437
140801,m. Legionowo,mazowieckie,40723,26243,25892,12462,13430
140802,gm. Jabłonna,mazowieckie,13033,8762,8635,3866,4769
140803,gm. Nieporęt,mazowieckie,10740,7296,7206,3543,3663
140804,gm. Serock,mazowieckie,11416,6612,6505,3427,3078
140805,gm. Wieliszew,mazowieckie,9993,6279,6179,3307,2872
140901,gm. Chotcza,mazowieckie,2028,830,823,543,280
140902,gm. Ciepielów,mazowieckie,4710,2282,2254,1604,650
140903,gm. Lipsko,mazowieckie,9574,4693,4634,2914,1720
140904,gm. Rzeczniów,mazowieckie,3769,1802,1784,1355,429
140905,gm. Sienno,mazowieckie,5018,2345,2325,1666,659
140906,gm. Solec nad Wisłą,mazowieckie,4416,2000,1983,1271,712
141001,gm. Huszlew,mazowieckie,2338,1244,1232,993,239
141002,gm. Łosice,mazowieckie,9114,4856,4780,3148,1632
141003,gm. Olszanka,mazowieckie,2480,1508,1495,1179,316
141004,gm. Platerów,mazowieckie,4090,2005,1979,1345,634
141005,gm. Sarnaki,mazowieckie,4242,2345,2319,1552,767
141006,gm. Stara Kornica,mazowieckie,3965,1994,1968,1542,426
141101,m. Maków Mazowiecki,mazowieckie,8046,4260,4219,2515,1704
141102,gm. Czerwonka,mazowieckie,2196,1210,1186,950,236
141103,gm. Karniewo,mazowieckie,4184,2221,2203,1668,535
141104,gm. Krasnosielc,mazowieckie,5196,2668,2639,1787,852
141105,gm. Młynarze,mazowieckie,1399,852,848,680,168
141106,gm. Płoniawy-Bramura,mazowieckie,4597,2280,2260,1657,603
141107,gm. Różan,mazowieckie,3703,2099,2078,1308,770
141108,gm. Rzewnie,mazowieckie,2250,1311,1295,936,359
141109,gm. Sypniewo,mazowieckie,2796,1557,1548,1181,367
141110,gm. Szelków,mazowieckie,2969,1648,1636,1206,430
141201,m. Mińsk Mazowiecki,mazowieckie,30702,19699,19364,9800,9564
141204,gm. Cegłów,mazowieckie,4930,2836,2782,1598,1184
141205,gm. Dębe Wielkie,mazowieckie,7486,4472,4395,2840,1555
141206,gm. Dobre,mazowieckie,4859,2719,2693,1860,833
141207,gm. Halinów,mazowieckie,11574,7445,7319,4290,3029
141208,gm. Jakubów,mazowieckie,4017,2289,2254,1593,661
141209,gm. Kałuszyn,mazowieckie,4717,2624,2594,1811,783
141210,gm. Latowicz,mazowieckie,4226,2132,2112,1586,526
141211,gm. Mińsk Mazowiecki,mazowieckie,11276,6899,6789,4263,2526
141212,gm. Mrozy,mazowieckie,7191,3838,3784,2414,1370
141213,gm. Siennica,mazowieckie,5722,3243,3172,2018,1154
141214,gm. Stanisławów,mazowieckie,5330,3196,3144,2303,841
141215,m. Sulejówek,mazowieckie,15271,10247,10122,5421,4701
141301,m. Mława,mazowieckie,24304,13344,13190,7050,6140
141302,gm. Dzierzgowo,mazowieckie,2615,1273,1263,933,330
141303,gm. Lipowiec Kościelny,mazowieckie,3921,1933,1914,1253,661
141304,gm. Radzanów,mazowieckie,2806,1344,1325,905,420
141305,gm. Strzegowo,mazowieckie,6333,2909,2879,1960,919
141306,gm. Stupsk,mazowieckie,4008,2015,1984,1361,623
141307,gm. Szreńsk,mazowieckie,3444,1689,1674,1224,450
141308,gm. Szydłowo,mazowieckie,3698,1847,1828,1180,648
141309,gm. Wieczfnia Kościelna,mazowieckie,3209,1601,1592,1184,408
141310,gm. Wiśniewo,mazowieckie,4188,2089,2063,1370,693
141401,m. Nowy Dwór Mazowiecki,mazowieckie,22088,12765,12564,5771,6793
141402,gm. Czosnów,mazowieckie,8175,5064,4997,2610,2387
141403,gm. Leoncin,mazowieckie,4542,2639,2596,1681,915
141404,gm. Nasielsk,mazowieckie,15703,8126,8034,5106,2928
141405,gm. Pomiechówek,mazowieckie,7354,4434,4366,2461,1905
141406,gm. Zakroczym,mazowieckie,5148,2470,2424,1447,977
141501,gm. Baranowo,mazowieckie,5380,2564,2549,1594,955
141502,gm. Czarnia,mazowieckie,2008,933,922,659,263
141503,gm. Czerwin,mazowieckie,4186,2200,2184,1758,426
141504,gm. Goworowo,mazowieckie,6962,3338,3303,2411,892
141505,gm. Kadzidło,mazowieckie,8755,4387,4339,3141,1198
141506,gm. Lelis,mazowieckie,7118,4059,4000,3019,981
141507,gm. Łyse,mazowieckie,6518,2963,2928,1880,1048
141508,gm. Myszyniec,mazowieckie,8264,4250,4207,3064,1143
141509,gm. Olszewo-Borki,mazowieckie,7946,4388,4323,3124,1199
141510,gm. Rzekuń,mazowieckie,8660,4786,4738,3182,1556
141511,gm. Troszyn,mazowieckie,3909,2101,2084,1624,460
141601,m. Ostrów Mazowiecka,mazowieckie,18259,10057,9940,6108,3832
141602,gm. Andrzejewo,mazowieckie,3514,2051,2033,1793,240
141603,gm. Boguty-Pianki,mazowieckie,2201,1281,1264,1071,193
141604,gm. Brok,mazowieckie,2403,1401,1390,897,493
141605,gm. Małkinia Górna,mazowieckie,9637,5445,5396,4013,1383
141606,gm. Nur,mazowieckie,2501,1478,1465,1187,278
141607,gm. Ostrów Mazowiecka,mazowieckie,10043,5236,5188,3834,1354
141608,gm. Stary Lubotyń,mazowieckie,3013,1699,1677,1393,284
141609,gm. Szulborze Wielkie,mazowieckie,1478,840,828,616,212
141610,gm. Wąsewo,mazowieckie,3609,1931,1910,1418,492
141611,gm. Zaręby Kościelne,mazowieckie,3042,1713,1689,1373,316
141701,m. Józefów,mazowieckie,14813,10273,10137,4875,5262
141702,m. Otwock,mazowieckie,36040,23183,22801,12040,10761
141703,gm. Celestynów,mazowieckie,9209,6247,6162,4056,2106
141704,gm. Karczew,mazowieckie,12725,8196,8110,4964,3146
141705,gm. Kołbiel,mazowieckie,6535,3957,3908,2735,1173
141706,gm. Osieck,mazowieckie,2891,1812,1789,1386,403
141707,gm. Sobienie-Jeziory,mazowieckie,5146,3041,2995,1954,1041
141708,gm. Wiązowna,mazowieckie,9214,6276,6188,3507,2681
141801,gm. Góra Kalwaria,mazowieckie,20511,12195,12033,6417,5616
141802,gm. Konstancin-Jeziorna,mazowieckie,20405,13244,13058,6024,7034
141803,gm. Lesznowola,mazowieckie,16820,11651,11471,4844,6627
141804,gm. Piaseczno,mazowieckie,56311,38461,37928,15701,22227
141805,gm. Prażmów,mazowieckie,7980,4894,4829,2598,2231
141806,gm. Tarczyn,mazowieckie,8905,5514,5438,3352,2086
141901,gm. Bielsk,mazowieckie,7154,3666,3634,2689,945
141902,gm. Bodzanów,mazowieckie,6703,3388,3354,2290,1064
141903,gm. Brudzeń Duży,mazowieckie,6456,3105,3061,2216,845
141904,gm. Bulkowo,mazowieckie,4647,2311,2288,1651,637
141905,gm. Drobin,mazowieckie,6450,2741,2710,1831,879
141906,gm. Gąbin,mazowieckie,9028,4801,4735,3307,1428
141907,gm. Łąck,mazowieckie,4298,2259,2215,1458,757
141908,gm. Mała Wieś,mazowieckie,5049,2446,2405,1626,779
141909,gm. Nowy Duninów,mazowieckie,3270,1675,1659,1098,561
141910,gm. Radzanowo,mazowieckie,6440,3353,3321,2119,1202
141911,gm. Słubice,mazowieckie,3670,1852,1833,1408,425
141912,gm. Słupno,mazowieckie,5568,3367,3311,1753,1558
141913,gm. Stara Biała,mazowieckie,8717,4791,4704,3095,1609
141914,gm. Staroźreby,mazowieckie,5896,2793,2752,1930,822
141915,gm. Wyszogród,mazowieckie,4724,2098,2067,1245,822
142001,m. Płońsk,mazowieckie,17803,9832,9695,5036,4659
142002,m. Raciąż,mazowieckie,3703,1887,1852,1179,673
142003,gm. Baboszewo,mazowieckie,6376,3070,3041,2105,936
142004,gm. Czerwińsk nad Wisłą,mazowieckie,6284,2461,2441,1656,785
142005,gm. Dzierzążnia,mazowieckie,3102,1465,1445,1012,433
142006,gm. Joniec,mazowieckie,2269,1201,1190,727,463
142007,gm. Naruszewo,mazowieckie,5193,2224,2204,1494,710
142008,gm. Nowe Miasto,mazowieckie,3890,1956,1938,1239,699
142009,gm. Płońsk,mazowieckie,6091,2893,2864,1773,1091
142010,gm. Raciąż,mazowieckie,7121,3234,3182,2424,758
142011,gm. Sochocin,mazowieckie,4860,2414,2392,1541,851
142012,gm. Załuski,mazowieckie,4522,2061,2035,1358,677
142101,m. Piastów,mazowieckie,18159,12138,11952,6088,5864
142102,m. Pruszków,mazowieckie,46330,30210,29768,13628,16140
142103,gm. Brwinów,mazowieckie,19461,13053,12859,5802,7057
142104,gm. Michałowice,mazowieckie,13165,9666,9539,3961,5578
142105,gm. Nadarzyn,mazowieckie,9776,6421,6335,2881,3454
142106,gm. Raszyn,mazowieckie,16613,11154,10996,6061,4935
142201,m. Przasnysz,mazowieckie,13732,7681,7584,4480,3104
142202,gm. Chorzele,mazowieckie,7979,3817,3775,2581,1194
142203,gm. Czernice Borowe,mazowieckie,3126,1598,1581,1206,375
142204,gm. Jednorożec,mazowieckie,5636,2576,2547,1615,932
142205,gm. Krasne,mazowieckie,3077,1398,1387,988,399
142206,gm. Krzynowłoga Mała,mazowieckie,2861,1530,1516,1286,230
142207,gm. Przasnysz,mazowieckie,5795,2969,2934,2269,665
142301,gm. Borkowice,mazowieckie,3658,1891,1848,1241,607
142302,gm. Gielniów,mazowieckie,3876,2214,2181,1709,472
142303,gm. Klwów,mazowieckie,2851,1814,1801,1429,372
142304,gm. Odrzywół,mazowieckie,3340,2116,2099,1807,292
142305,gm. Potworów,mazowieckie,3379,1822,1790,1408,382
142306,gm. Przysucha,mazowieckie,10226,5859,5776,4034,1742
142307,gm. Rusinów,mazowieckie,3564,2128,2101,1734,367
142308,gm. Wieniawa,mazowieckie,4412,2414,2370,1839,531
142401,gm. Gzy,mazowieckie,3184,1619,1594,1171,423
142402,gm. Obryte,mazowieckie,4009,2423,2373,1764,609
142403,gm. Pokrzywnica,mazowieckie,3949,1949,1932,1355,577
142404,gm. Pułtusk,mazowieckie,19044,10454,10284,6069,4215
142405,gm. Świercze,mazowieckie,3831,1854,1831,1176,655
142406,gm. Winnica,mazowieckie,3233,1853,1832,1179,653
142407,gm. Zatory,mazowieckie,3893,2231,2205,1642,563
142501,m. Pionki,mazowieckie,15601,8213,8079,4577,3502
142502,gm. Gózd,mazowieckie,6676,3989,3958,3253,705
142503,gm. Iłża,mazowieckie,12471,6021,5944,4058,1886
142504,gm. Jastrzębia,mazowieckie,5427,2979,2956,2171,785
142505,gm. Jedlińsk,mazowieckie,10787,6041,5956,4451,1505
142506,gm. Jedlnia-Letnisko,mazowieckie,9858,5936,5863,4110,1753
142507,gm. Kowala,mazowieckie,9050,5452,5396,3882,1514
142508,gm. Pionki,mazowieckie,8138,4231,4186,3046,1140
142509,gm. Przytyk,mazowieckie,5637,3169,3147,2509,638
142510,gm. Skaryszew,mazowieckie,11038,6503,6455,5080,1375
142511,gm. Wierzbica,mazowieckie,7894,4132,4081,3089,992
142512,gm. Wolanów,mazowieckie,6704,3797,3738,2803,935
142513,gm. Zakrzew,mazowieckie,9618,5913,5852,4498,1354
142601,gm. Domanice,mazowieckie,2109,1259,1256,1047,209
142602,gm. Korczew,mazowieckie,2365,1206,1185,781,404
142603,gm. Kotuń,mazowieckie,6854,3708,3658,2552,1106
142604,gm. Mokobody,mazowieckie,4112,2330,2307,1843,464
142605,gm. Mordy,mazowieckie,4951,2586,2552,1856,696
142606,gm. Paprotnia,mazowieckie,2199,1382,1375,1181,194
142607,gm. Przesmyki,mazowieckie,2814,1474,1450,1118,332
142608,gm. Siedlce,mazowieckie,13550,7954,7842,5516,2326
142609,gm. Skórzec,mazowieckie,5958,3370,3338,2676,662
142610,gm. Suchożebry,mazowieckie,3792,2061,2037,1495,542
142611,gm. Wiśniew,mazowieckie,4569,2903,2884,2451,433
142612,gm. Wodynie,mazowieckie,3700,2032,2015,1621,394
142613,gm. Zbuczyn,mazowieckie,7892,5063,5017,4187,830
142701,m. Sierpc,mazowieckie,14900,7868,7792,4391,3401
142702,gm. Gozdowo,mazowieckie,4746,2226,2198,1552,646
142703,gm. Mochowo,mazowieckie,4889,2241,2220,1620,600
142704,gm. Rościszewo,mazowieckie,3433,1742,1727,1341,386
142705,gm. Sierpc,mazowieckie,5541,2589,2566,1758,808
142706,gm. Szczutowo,mazowieckie,3558,1591,1582,1113,469
142707,gm. Zawidz,mazowieckie,5480,2767,2736,1855,881
142801,m. Sochaczew,mazowieckie,29917,16682,16470,8490,7980
142802,gm. Brochów,mazowieckie,3558,1831,1812,1218,594
142803,gm. Iłów,mazowieckie,4958,2745,2717,2014,703
142804,gm. Młodzieszyn,mazowieckie,4487,2247,2217,1622,595
142805,gm. Nowa Sucha,mazowieckie,5165,2858,2827,1906,921
142806,gm. Rybno,mazowieckie,2770,1499,1481,1099,382
142807,gm. Sochaczew,mazowieckie,7987,4413,4346,2776,1570
142808,gm. Teresin,mazowieckie,8997,5345,5289,3344,1945
142901,m. Sokołów Podlaski,mazowieckie,15253,9218,9087,5679,3408
142902,gm. Bielany,mazowieckie,3024,1901,1885,1624,261
142903,gm. Ceranów,mazowieckie,1971,1112,1103,870,233
142904,gm. Jabłonna Lacka,mazowieckie,3960,2267,2235,1718,517
142905,gm. Kosów Lacki,mazowieckie,5231,2960,2938,2164,774
142906,gm. Repki,mazowieckie,4542,2641,2628,1989,639
142907,gm. Sabnie,mazowieckie,3197,1849,1835,1306,529
142908,gm. Sokołów Podlaski,mazowieckie,4948,2851,2811,2125,686
142909,gm. Sterdyń,mazowieckie,3572,1974,1961,1386,575
143001,gm. Chlewiska,mazowieckie,5200,2378,2327,1777,550
143002,gm. Jastrząb,mazowieckie,4178,2159,2123,1653,470
143003,gm. Mirów,mazowieckie,3019,1637,1620,1362,258
143004,gm. Orońsko,mazowieckie,4662,2554,2532,1854,678
143005,gm. Szydłowiec,mazowieckie,15166,8159,8038,5542,2496
143201,gm. Błonie,mazowieckie,16528,10128,9992,5179,4813
143202,gm. Izabelin,mazowieckie,8198,5830,5769,2824,2945
143203,gm. Kampinos,mazowieckie,3491,2135,2103,1266,837
143204,gm. Leszno,mazowieckie,7674,4635,4580,2302,2278
143205,gm. Łomianki,mazowieckie,18932,13545,13404,5875,7529
143206,gm. Ożarów Mazowiecki,mazowieckie,17607,11179,11026,5918,5108
143207,gm. Stare Babice,mazowieckie,13298,8934,8847,4181,4666
143301,m. Węgrów,mazowieckie,10383,6160,6088,3274,2814
143302,gm. Grębków,mazowieckie,3637,1888,1865,1405,460
143303,gm. Korytnica,mazowieckie,5214,2960,2930,2268,662
143304,gm. Liw,mazowieckie,6140,3498,3463,2331,1132
143305,gm. Łochów,mazowieckie,14274,8212,8111,5741,2370
143306,gm. Miedzna,mazowieckie,3350,2008,1986,1470,516
143307,gm. Sadowne,mazowieckie,4966,2730,2701,1906,795
143308,gm. Stoczek,mazowieckie,4189,2304,2285,1664,621
143309,gm. Wierzbno,mazowieckie,2423,1317,1298,955,343
143401,m. Kobyłka,mazowieckie,16366,10896,10757,6228,4529
143402,m. Marki,mazowieckie,21693,13419,13246,7208,6038
143403,m. Ząbki,mazowieckie,23288,15620,15384,8235,7149
143404,m. Zielonka,mazowieckie,13499,9184,9042,4844,4198
143405,gm. Dąbrówka,mazowieckie,6076,3868,3829,2975,854
143406,gm. Jadów,mazowieckie,6300,3419,3381,2123,1258
143407,gm. Klembów,mazowieckie,7422,4476,4404,3059,1345
143408,gm. Poświętne,mazowieckie,4814,2814,2778,2246,532
143409,gm. Radzymin,mazowieckie,18772,11808,11667,7691,3976
143410,gm. Strachówka,mazowieckie,2389,1237,1215,842,373
143411,gm. Tłuszcz,mazowieckie,15271,8996,8878,6158,2720
143412,gm. Wołomin,mazowieckie,40151,25500,25128,14660,10468
143501,gm. Brańszczyk,mazowieckie,6774,3797,3774,2614,1160
143502,gm. Długosiodło,mazowieckie,6173,3278,3242,2256,986
143503,gm. Rząśnik,mazowieckie,5490,3399,3363,2644,719
143504,gm. Somianka,mazowieckie,4673,2743,2685,1769,916
143505,gm. Wyszków,mazowieckie,30786,18309,18082,11274,6808
143506,gm. Zabrodzie,mazowieckie,4625,2650,2615,1929,686
143601,gm. Kazanów,mazowieckie,3681,2015,1989,1503,486
143602,gm. Policzna,mazowieckie,4874,2378,2346,1788,558
143603,gm. Przyłęk,mazowieckie,5075,2509,2487,1947,540
143604,gm. Tczów,mazowieckie,3811,2031,2017,1645,372
143605,gm. Zwoleń,mazowieckie,12329,6818,6705,4761,1944
143701,gm. Bieżuń,mazowieckie,4151,1968,1944,1320,624
143702,gm. Kuczbork-Osada,mazowieckie,3933,1807,1787,1022,765
143703,gm. Lubowidz,mazowieckie,5732,2750,2719,1681,1038
143704,gm. Lutocin,mazowieckie,3635,1732,1720,1270,450
143705,gm. Siemiątkowo,mazowieckie,2865,1292,1276,964,312
143706,gm. Żuromin,mazowieckie,11960,6081,6012,3232,2780
143801,m. Żyrardów,mazowieckie,31632,18646,18389,8842,9547
143802,gm. Mszczonów,mazowieckie,9106,5120,5055,3214,1841
143803,gm. Puszcza Mariańska,mazowieckie,6877,3766,3704,2179,1525
143804,gm. Radziejowice,mazowieckie,4357,2619,2577,1425,1152
143805,gm. Wiskitki,mazowieckie,7828,4252,4190,2849,1341
146101,m. Ostrołęka,mazowieckie,41639,23788,23467,14096,9371
146201,m. Płock,mazowieckie,98157,56732,55939,29128,26811
146301,m. Radom,mazowieckie,169861,100500,99050,54225,44825
146401,m. Siedlce,mazowieckie,61223,37158,36590,21357,15233
146502,Bemowo,mazowieckie,92421,65504,64462,24001,40461
146503,Białołęka,mazowieckie,77961,54692,53796,21088,32708
146504,Bielany,mazowieckie,105604,72634,71512,31196,40316
146505,Mokotów,mazowieckie,176469,121039,119056,43381,75675
146506,Ochota,mazowieckie,67337,45492,44839,17599,27240
146507,Praga-Południe,mazowieckie,143095,97097,95611,39843,55768
146508,Praga-Północ,mazowieckie,52335,30896,30386,14740,15646
146509,Rembertów,mazowieckie,18085,12218,11971,5325,6646
146510,Śródmieście,mazowieckie,95970,64350,63364,25225,38139
146511,Targówek,mazowieckie,97191,63487,62617,29390,33227
146512,Ursus,mazowieckie,42300,28818,28370,12968,15402
146513,Ursynów,mazowieckie,114169,84606,83185,28409,54776
146514,Wawer,mazowieckie,56415,40013,39562,18099,21463
146515,Wesoła,mazowieckie,17631,12959,12749,5557,7192
146516,Wilanów,mazowieckie,21916,16730,16543,5078,11465
146517,Włochy,mazowieckie,30602,21036,20711,8861,11850
146518,Wola,mazowieckie,111025,71199,70025,30278,39747
146519,Żoliborz,mazowieckie,39986,28450,28019,10826,17193
149901,Zagranica,mazowieckie,257062,132380,158407,88607,69800
160101,m. Brzeg,opolskie,29385,15204,14973,7273,7700
160102,gm. Skarbimierz,opolskie,5920,3132,3092,1705,1387
160103,gm. Grodków,opolskie,15561,7076,6995,3545,3450
160104,gm. Lewin Brzeski,opolskie,10470,4856,4771,2564,2207
160105,gm. Lubsza,opolskie,7205,3536,3481,1945,1536
160106,gm. Olszanka,opolskie,3988,2071,2044,1284,760
160201,gm. Baborów,opolskie,5088,2169,2140,1172,968
160202,gm. Branice,opolskie,5838,2597,2556,1443,1113
160203,gm. Głubczyce,opolskie,18577,9329,9212,5236,3976
160204,gm. Kietrz,opolskie,9043,4484,4436,2426,2010
160301,m. Kędzierzyn-Koźle,opolskie,49074,24801,24327,9196,15131
160302,gm. Bierawa,opolskie,6231,2589,2538,948,1590
160303,gm. Cisek,opolskie,4662,1785,1761,557,1204
160304,gm. Pawłowiczki,opolskie,6379,2532,2495,953,1542
160305,gm. Polska Cerekiew,opolskie,3557,1494,1478,420,1058
160306,gm. Reńska Wieś,opolskie,6738,2537,2509,897,1612
160401,gm. Byczyna,opolskie,7507,3545,3496,1705,1791
160402,gm. Kluczbork,opolskie,30142,14625,14401,6127,8274
160403,gm. Lasowice Wielkie,opolskie,5813,2019,1994,621,1373
160404,gm. Wołczyn,opolskie,11017,5172,5112,2721,2391
160501,gm. Gogolin,opolskie,10165,3866,3817,1253,2564
160502,gm. Krapkowice,opolskie,18887,8316,8166,2823,5343
160503,gm. Strzeleczki,opolskie,6237,2377,2351,722,1629
160504,gm. Walce,opolskie,4663,1595,1568,415,1153
160505,gm. Zdzieszowice,opolskie,12473,5367,5249,1902,3347
160601,gm. Domaszowice,opolskie,2982,1684,1661,862,799
160602,gm. Namysłów,opolskie,20749,11009,10859,5262,5597
160603,gm. Pokój,opolskie,4326,1851,1821,667,1154
160604,gm. Świerczów,opolskie,2872,1445,1431,660,771
160605,gm. Wilków,opolskie,3593,1699,1671,793,878
160701,gm. Głuchołazy,opolskie,20767,9502,9345,4558,4787
160702,gm. Kamiennik,opolskie,2908,1320,1305,786,519
160703,gm. Korfantów,opolskie,7748,3107,3054,1664,1390
160704,gm. Łambinowice,opolskie,6137,2715,2676,1378,1298
160705,gm. Nysa,opolskie,47681,23868,23564,11072,12492
160706,gm. Otmuchów,opolskie,11311,5527,5427,3044,2383
160707,gm. Paczków,opolskie,10577,5052,4985,2682,2303
160708,gm. Pakosławice,opolskie,3022,1504,1483,858,625
160709,gm. Skoroszyce,opolskie,5082,2211,2171,1286,885
160801,gm. Dobrodzień,opolskie,8124,3077,3003,1071,1932
160802,gm. Gorzów Śląski,opolskie,5994,2407,2376,1043,1333
160803,gm. Olesno,opolskie,14819,6413,6302,2278,4024
160804,gm. Praszka,opolskie,11244,6221,6101,3121,2980
160805,gm. Radłów,opolskie,3542,1262,1247,449,798
160806,gm. Rudniki,opolskie,6815,3486,3423,1874,1549
160807,gm. Zębowice,opolskie,3045,1124,1105,509,596
160901,gm. Chrząstowice,opolskie,5493,2343,2314,656,1658
160902,gm. Dąbrowa,opolskie,7771,3671,3575,1285,2290
160903,gm. Dobrzeń Wielki,opolskie,11881,5212,5119,1607,3512
160904,gm. Komprachcice,opolskie,9015,4074,4028,1215,2813
160905,gm. Łubniany,opolskie,7855,3242,3202,785,2417
160906,gm. Murów,opolskie,4631,1689,1655,440,1215
160907,gm. Niemodlin,opolskie,10571,4931,4867,2421,2446
160908,gm. Ozimek,opolskie,16597,6783,6689,2383,4306
160909,gm. Popielów,opolskie,6644,2651,2610,921,1689
160910,gm. Prószków,opolskie,7875,3338,3279,1013,2266
160911,gm. Tarnów Opolski,opolskie,7774,3168,3123,1053,2070
160912,gm. Tułowice,opolskie,4257,2163,2135,985,1150
160913,gm. Turawa,opolskie,8030,3241,3191,936,2255
161001,gm. Biała,opolskie,8974,3474,3427,1086,2341
161002,gm. Głogówek,opolskie,10941,4602,4556,1778,2778
161003,gm. Lubrza,opolskie,3508,1829,1802,999,803
161004,gm. Prudnik,opolskie,22259,11305,11153,6193,4960
161101,gm. Izbicko,opolskie,4435,1823,1793,530,1263
161102,gm. Jemielnica,opolskie,5961,2116,2066,874,1192
161103,gm. Kolonowskie,opolskie,4983,1825,1791,659,1132
161104,gm. Leśnica,opolskie,6451,2663,2628,1016,1612
161105,gm. Strzelce Opolskie,opolskie,26341,12051,11886,4060,7826
161106,gm. Ujazd,opolskie,5118,2152,2105,852,1253
161107,gm. Zawadzkie,opolskie,9757,3821,3758,1904,1854
166101,m. Opole,opolskie,95232,55134,54191,18124,36067
180103,gm. Czarna,podkarpackie,1942,892,879,536,343
180105,gm. Lutowiska,podkarpackie,1815,851,838,435,403
180108,gm. Ustrzyki Dolne,podkarpackie,14245,6633,6565,3891,2674
180201,gm. Brzozów,podkarpackie,21289,11662,11574,9021,2553
180202,gm. Domaradz,podkarpackie,4848,2752,2730,2331,399
180203,gm. Dydnia,podkarpackie,6492,3238,3208,2669,539
180204,gm. Haczów,podkarpackie,7380,4175,4135,3274,861
180205,gm. Jasienica Rosielna,podkarpackie,5995,3995,3962,3477,485
180206,gm. Nozdrzec,podkarpackie,6770,3534,3488,2565,923
180301,m. Dębica,podkarpackie,37579,21756,21489,13663,7826
180302,gm. Brzostek,podkarpackie,10362,5604,5485,4686,799
180303,gm. Czarna,podkarpackie,10134,5808,5731,4435,1296
180304,gm. Dębica,podkarpackie,19541,11208,11099,8495,2604
180305,gm. Jodłowa,podkarpackie,4316,2192,2169,1799,370
180306,gm. Pilzno,podkarpackie,14097,8414,8342,6832,1510
180307,gm. Żyraków,podkarpackie,10919,6411,6346,5015,1331
180401,m. Jarosław,podkarpackie,31348,17192,16993,10611,6382
180402,m. Radymno,podkarpackie,4434,2429,2412,1762,650
180403,gm. Chłopice,podkarpackie,4557,2408,2380,1864,516
180404,gm. Jarosław,podkarpackie,10322,5592,5536,4091,1445
180405,gm. Laszki,podkarpackie,5505,2873,2839,2048,791
180406,gm. Pawłosiów,podkarpackie,6790,3921,3884,2883,1001
180407,gm. Pruchnik,podkarpackie,7730,4452,4398,3787,611
180408,gm. Radymno,podkarpackie,8942,4758,4702,3637,1065
180409,gm. Rokietnica,podkarpackie,3520,1839,1809,1505,304
180410,gm. Roźwienica,podkarpackie,4968,2721,2692,2094,598
180411,gm. Wiązownica,podkarpackie,9080,5385,5317,4260,1057
180501,m. Jasło,podkarpackie,29625,16380,16181,10316,5865
180502,gm. Brzyska,podkarpackie,5083,2847,2814,2473,341
180503,gm. Dębowiec,podkarpackie,6771,3778,3759,3083,676
180504,gm. Jasło,podkarpackie,13373,7595,7520,5921,1599
180505,gm. Kołaczyce,podkarpackie,7061,3892,3883,3208,675
180506,gm. Krempna,podkarpackie,1584,732,721,469,252
180507,gm. Nowy Żmigród,podkarpackie,7516,4267,4239,3426,813
180508,gm. Osiek Jasielski,podkarpackie,4262,2262,2246,1907,339
180509,gm. Skołyszyn,podkarpackie,10028,5476,5422,4023,1399
180511,gm. Tarnowiec,podkarpackie,7460,4120,4078,3162,916
180601,gm. Cmolas,podkarpackie,6253,3263,3214,2731,483
180602,gm. Kolbuszowa,podkarpackie,19753,10607,10450,7808,2642
180603,gm. Majdan Królewski,podkarpackie,7779,4073,4024,3475,549
180604,gm. Niwiska,podkarpackie,4614,2571,2547,2096,451
180605,gm. Raniżów,podkarpackie,5608,3172,3117,2597,520
180606,gm. Dzikowiec,podkarpackie,5113,2482,2447,2074,373
180701,gm. Chorkówka,podkarpackie,10594,5768,5728,4243,1485
180702,gm. Dukla,podkarpackie,11710,6038,5984,4356,1628
180703,gm. Iwonicz-Zdrój,podkarpackie,9412,5555,5501,3996,1505
180704,gm. Jedlicze,podkarpackie,12333,6419,6359,4494,1865
180705,gm. Korczyna,podkarpackie,8909,4883,4810,3583,1227
180706,gm. Krościenko Wyżne,podkarpackie,4323,2573,2545,1899,646
180707,gm. Miejsce Piastowe,podkarpackie,10878,6303,6247,4448,1799
180708,gm. Rymanów,podkarpackie,13590,7732,7659,5631,2028
180709,gm. Wojaszówka,podkarpackie,7384,3786,3740,2636,1104
180710,gm. Jaśliska,podkarpackie,1593,814,805,634,171
180801,m. Leżajsk,podkarpackie,11725,6453,6379,4451,1928
180802,gm. Grodzisko Dolne,podkarpackie,6483,3834,3807,3222,585
180803,gm. Kuryłówka,podkarpackie,4556,2363,2336,1851,485
180804,gm. Leżajsk,podkarpackie,15638,8623,8545,7277,1268
180805,gm. Nowa Sarzyna,podkarpackie,16753,9663,9578,8298,1280
180901,m. Lubaczów,podkarpackie,10151,5279,5196,3130,2066
180902,gm. Cieszanów,podkarpackie,6027,2897,2871,2033,838
180903,gm. Horyniec-Zdrój,podkarpackie,4384,2189,2162,1415,747
180904,gm. Lubaczów,podkarpackie,7371,3565,3529,2658,871
180905,gm. Narol,podkarpackie,6677,3156,3117,2253,864
180906,gm. Oleszyce,podkarpackie,5250,2815,2778,1969,809
180907,gm. Stary Dzików,podkarpackie,3629,1810,1800,1377,423
180908,gm. Wielkie Oczy,podkarpackie,3027,1605,1578,1140,438
181001,m. Łańcut,podkarpackie,14586,8897,8816,5954,2862
181002,gm. Białobrzegi,podkarpackie,6617,3830,3795,3104,691
181003,gm. Czarna,podkarpackie,8966,5533,5482,4620,862
181004,gm. Łańcut,podkarpackie,16649,10580,10481,8522,1959
181005,gm. Markowa,podkarpackie,5230,3048,3015,2562,453
181006,gm. Rakszawa,podkarpackie,5693,3410,3378,2881,497
181007,gm. Żołynia,podkarpackie,5416,3100,3080,2410,670
181101,m. Mielec,podkarpackie,49123,27634,27260,17778,9482
181102,gm. Borowa,podkarpackie,4483,2504,2471,1846,625
181103,gm. Czermin,podkarpackie,5503,2949,2917,2341,576
181104,gm. Gawłuszowice,podkarpackie,2207,1294,1276,1046,230
181105,gm. Mielec,podkarpackie,10277,5941,5864,4460,1404
181106,gm. Padew Narodowa,podkarpackie,4244,2410,2381,1940,441
181107,gm. Przecław,podkarpackie,8997,5004,4961,4067,894
181108,gm. Radomyśl Wielki,podkarpackie,10959,5766,5690,4501,1189
181109,gm. Tuszów Narodowy,podkarpackie,6234,3827,3784,3149,635
181110,gm. Wadowice Górne,podkarpackie,5815,3141,3115,2507,608
181201,gm. Harasiuki,podkarpackie,5049,2465,2432,1993,439
181202,gm. Jarocin,podkarpackie,4377,2048,2024,1596,428
181203,gm. Jeżowe,podkarpackie,7771,4566,4518,4149,369
181204,gm. Krzeszów,podkarpackie,3462,1714,1684,1404,280
181205,gm. Nisko,podkarpackie,18106,9459,9320,6834,2486
181206,gm. Rudnik nad Sanem,podkarpackie,8268,4082,4001,2922,1079
181207,gm. Ulanów,podkarpackie,6942,3311,3262,2629,633
181301,gm. Bircza,podkarpackie,5463,2621,2597,1919,678
181302,gm. Dubiecko,podkarpackie,7552,3646,3605,2641,964
181303,gm. Fredropol,podkarpackie,4484,2248,2218,1477,741
181304,gm. Krasiczyn,podkarpackie,3990,2111,2065,1347,718
181305,gm. Krzywcza,podkarpackie,3972,1935,1918,1511,407
181306,gm. Medyka,podkarpackie,5263,2745,2722,1943,779
181307,gm. Orły,podkarpackie,6863,3645,3614,2652,962
181308,gm. Przemyśl,podkarpackie,8119,4421,4379,2973,1406
181309,gm. Stubno,podkarpackie,3199,1405,1392,908,484
181310,gm. Żurawica,podkarpackie,10340,5663,5596,3967,1629
181401,m. Przeworsk,podkarpackie,12756,7166,7068,4850,2218
181402,gm. Adamówka,podkarpackie,3354,1705,1689,1211,478
181403,gm. Gać,podkarpackie,3666,1988,1960,1494,466
181404,gm. Jawornik Polski,podkarpackie,3897,2038,2021,1468,553
181405,gm. Kańczuga,podkarpackie,10128,4993,4951,3339,1612
181406,gm. Przeworsk,podkarpackie,11763,6887,6796,5713,1083
181407,gm. Sieniawa,podkarpackie,5689,2929,2909,2090,819
181408,gm. Tryńcza,podkarpackie,6537,3655,3628,3144,484
181409,gm. Zarzecze,podkarpackie,5754,3223,3185,2403,782
181501,gm. Iwierzyce,podkarpackie,6010,3655,3617,2973,644
181502,gm. Ostrów,podkarpackie,5740,3060,3032,2489,543
181503,gm. Ropczyce,podkarpackie,21131,12448,12290,9795,2495
181504,gm. Sędziszów Małopolski,podkarpackie,18507,11376,11239,9320,1919
181505,gm. Wielopole Skrzyńskie,podkarpackie,6454,3694,3664,3087,577
181601,m. Dynów,podkarpackie,4999,2747,2718,1971,747
181602,gm. Błażowa,podkarpackie,8684,4990,4943,4052,891
181603,gm. Boguchwała,podkarpackie,15551,9768,9622,7200,2422
181604,gm. Chmielnik,podkarpackie,5261,3262,3220,2635,585
181605,gm. Dynów,podkarpackie,5650,2837,2807,2206,601
181606,gm. Głogów Małopolski,podkarpackie,15037,9424,9303,6931,2372
181607,gm. Hyżne,podkarpackie,5482,3572,3539,3004,535
181608,gm. Kamień,podkarpackie,5446,3103,3075,2728,347
181609,gm. Krasne,podkarpackie,8394,5389,5350,3897,1453
181610,gm. Lubenia,podkarpackie,5181,3245,3204,2631,573
181611,gm. Sokołów Małopolski,podkarpackie,13168,7890,7812,6606,1206
181612,gm. Świlcza,podkarpackie,12601,7574,7479,5662,1817
181613,gm. Trzebownisko,podkarpackie,15978,10004,9869,7510,2359
181614,gm. Tyczyn,podkarpackie,8896,5421,5366,4170,1196
181701,m. Sanok,podkarpackie,31264,16260,16044,8918,7126
181702,gm. Besko,podkarpackie,3446,1673,1644,1213,431
181703,gm. Bukowsko,podkarpackie,4274,2246,2216,1573,643
181704,gm. Komańcza,podkarpackie,4602,1789,1769,764,1005
181705,gm. Sanok,podkarpackie,13885,7287,7202,5542,1660
181706,gm. Tyrawa Wołoska,podkarpackie,1548,708,700,513,187
181707,gm. Zagórz,podkarpackie,10444,5226,5191,3585,1606
181708,gm. Zarszyn,podkarpackie,7470,3695,3650,2313,1337
181801,m. Stalowa Wola,podkarpackie,50011,27189,26799,17070,9729
181802,gm. Bojanów,podkarpackie,5835,3117,3088,2673,415
181803,gm. Pysznica,podkarpackie,8301,4171,4107,3199,908
181804,gm. Radomyśl nad Sanem,podkarpackie,5904,2906,2887,2135,752
181805,gm. Zaklików,podkarpackie,7008,3488,3450,2434,1016
181806,gm. Zaleszany,podkarpackie,8679,4591,4529,3339,1190
181901,gm. Czudec,podkarpackie,9307,5618,5535,4417,1118
181902,gm. Frysztak,podkarpackie,8427,4327,4256,3373,883
181903,gm. Niebylec,podkarpackie,8525,4992,4949,4089,860
181904,gm. Strzyżów,podkarpackie,16764,8750,8640,6251,2389
181905,gm. Wiśniowa,podkarpackie,6651,3663,3620,2913,707
182001,gm. Baranów Sandomierski,podkarpackie,9683,5201,5151,3955,1196
182002,gm. Gorzyce,podkarpackie,10675,5355,5307,3430,1877
182003,gm. Grębów,podkarpackie,7949,4109,4069,3070,999
182004,gm. Nowa Dęba,podkarpackie,15258,7708,7621,5350,2271
182101,gm. Baligród,podkarpackie,2730,1359,1340,906,434
182102,gm. Cisna,podkarpackie,1606,909,887,444,443
182103,gm. Lesko,podkarpackie,9463,4748,4715,3088,1627
182104,gm. Olszanica,podkarpackie,4489,2184,2156,1412,744
182105,gm. Solina,podkarpackie,5151,2981,2948,1993,955
186101,m. Krosno,podkarpackie,38029,21483,21235,12230,9005
186201,m. Przemyśl,podkarpackie,50948,26986,26655,14627,12028
186301,m. Rzeszów,podkarpackie,143217,88269,87004,49203,37801
186401,m. Tarnobrzeg,podkarpackie,38466,20815,20482,10794,9688
200101,m. Augustów,podlaskie,24015,12463,12319,6642,5677
200102,gm. Augustów,podlaskie,5380,2497,2463,1607,856
200103,gm. Bargłów Kościelny,podlaskie,4549,1828,1807,1202,605
200104,gm. Lipsk,podlaskie,4495,1956,1937,1256,681
200105,gm. Nowinka,podlaskie,2435,1308,1292,796,496
200106,gm. Płaska,podlaskie,2211,1124,1117,605,512
200107,gm. Sztabin,podlaskie,4328,1945,1914,1142,772
200201,gm. Choroszcz,podlaskie,12143,6770,6647,4253,2394
200202,gm. Czarna Białostocka,podlaskie,9122,4662,4574,2714,1860
200203,gm. Dobrzyniewo Duże,podlaskie,6960,3700,3652,2281,1371
200204,gm. Gródek,podlaskie,4628,2083,2043,527,1516
200205,gm. Juchnowiec Kościelny,podlaskie,11898,7120,6992,4516,2476
200206,gm. Łapy,podlaskie,17886,10211,10063,7437,2626
200207,gm. Michałowo,podlaskie,5821,2518,2472,1046,1426
200208,gm. Poświętne,podlaskie,2923,1651,1627,1308,319
200209,gm. Supraśl,podlaskie,11489,7449,7223,3324,3899
200210,gm. Suraż,podlaskie,1615,963,952,730,222
200211,gm. Turośń Kościelna,podlaskie,4710,2902,2821,1928,893
200212,gm. Tykocin,podlaskie,5205,2691,2645,2137,508
200213,gm. Wasilków,podlaskie,11605,6437,6348,3570,2778
200214,gm. Zabłudów,podlaskie,7252,3678,3632,2150,1482
200215,gm. Zawady,podlaskie,2347,1130,1101,930,171
200301,m. Bielsk Podlaski,podlaskie,21377,10891,10778,4362,6416
200302,m. Brańsk,podlaskie,3104,1872,1850,1497,353
200303,gm. Bielsk Podlaski,podlaskie,6105,2668,2640,1052,1588
200304,gm. Boćki,podlaskie,3811,1950,1937,1288,649
200305,gm. Brańsk,podlaskie,4955,2987,2962,2611,351
200306,gm. Orla,podlaskie,2609,1174,1156,178,978
200307,gm. Rudka,podlaskie,1481,807,788,611,177
200308,gm. Wyszki,podlaskie,3774,2106,2098,1727,371
200401,m. Grajewo,podlaskie,17480,8439,8328,5097,3231
200402,gm. Grajewo,podlaskie,4642,1979,1957,1379,578
200403,gm. Radziłów,podlaskie,4055,1918,1899,1513,386
200404,gm. Rajgród,podlaskie,4423,1850,1804,1037,767
200405,gm. Szczuczyn,podlaskie,5155,2378,2353,1631,722
200406,gm. Wąsosz,podlaskie,3042,1455,1443,1107,336
200501,m. Hajnówka,podlaskie,18173,8534,8376,2589,5787
200502,gm. Białowieża,podlaskie,2040,1010,1000,325,675
200503,gm. Czeremcha,podlaskie,2907,1226,1213,418,795
200504,gm. Czyże,podlaskie,1934,811,796,133,663
200505,gm. Dubicze Cerkiewne,podlaskie,1492,630,616,166,450
200506,gm. Hajnówka,podlaskie,3456,1394,1365,337,1028
200507,gm. Kleszczele,podlaskie,2302,1086,1071,364,707
200508,gm. Narew,podlaskie,3191,1301,1279,422,857
200509,gm. Narewka,podlaskie,3330,1328,1301,309,992
200601,m. Kolno,podlaskie,8520,4082,4041,2659,1382
200602,gm. Grabowo,podlaskie,2900,1365,1349,1044,305
200603,gm. Kolno,podlaskie,6883,3450,3424,2660,764
200604,gm. Mały Płock,podlaskie,4027,1889,1863,1494,369
200605,gm. Stawiski,podlaskie,5099,2339,2321,1867,454
200606,gm. Turośl,podlaskie,3936,1955,1941,1479,462
200701,gm. Jedwabne,podlaskie,4470,2340,2317,1982,335
200702,gm. Łomża,podlaskie,8694,4788,4730,3376,1354
200703,gm. Miastkowo,podlaskie,3363,1681,1657,1401,256
200704,gm. Nowogród,podlaskie,3237,1655,1637,1163,474
200705,gm. Piątnica,podlaskie,8339,3961,3923,2920,1003
200706,gm. Przytuły,podlaskie,1764,891,883,780,103
200707,gm. Śniadowo,podlaskie,4404,2450,2431,2010,421
200708,gm. Wizna,podlaskie,3458,1723,1703,1406,297
200709,gm. Zbójna,podlaskie,3506,1597,1579,1160,419
200801,gm. Goniądz,podlaskie,4154,1862,1840,1257,583
200802,gm. Jasionówka,podlaskie,2402,1076,1064,746,318
200803,gm. Jaświły,podlaskie,4305,1824,1795,1357,438
200804,gm. Knyszyn,podlaskie,3973,1849,1820,1290,530
200805,gm. Krypno,podlaskie,3223,1456,1429,1025,404
200806,gm. Mońki,podlaskie,12810,5529,5433,3471,1962
200807,gm. Trzcianne,podlaskie,3716,1512,1494,1175,319
200901,m. Sejny,podlaskie,4524,2321,2296,981,1315
200902,gm. Giby,podlaskie,2467,1298,1283,668,615
200903,gm. Krasnopol,podlaskie,3190,1495,1481,725,756
200904,gm. Puńsk,podlaskie,3518,1426,1406,346,1060
200905,gm. Sejny,podlaskie,3477,1459,1433,707,726
201001,m. Siemiatycze,podlaskie,11918,6072,5996,3023,2973
201002,gm. Drohiczyn,podlaskie,5454,2626,2590,1864,726
201003,gm. Dziadkowice,podlaskie,2444,1195,1182,899,283
201004,gm. Grodzisk,podlaskie,3549,1906,1884,1320,564
201005,gm. Mielnik,podlaskie,2290,1158,1141,461,680
201006,gm. Milejczyce,podlaskie,1726,810,802,274,528
201007,gm. Nurzec-Stacja,podlaskie,3530,1318,1298,537,761
201008,gm. Perlejewo,podlaskie,2484,1167,1158,926,232
201009,gm. Siemiatycze,podlaskie,5074,2302,2280,1104,1176
201101,gm. Dąbrowa Białostocka,podlaskie,10052,4851,4805,3237,1568
201102,gm. Janów,podlaskie,3550,1465,1447,909,538
201103,gm. Korycin,podlaskie,2676,1206,1192,866,326
201104,gm. Krynki,podlaskie,2763,1306,1289,733,556
201105,gm. Kuźnica,podlaskie,3426,1793,1765,1238,527
201106,gm. Nowy Dwór,podlaskie,2388,1053,1044,657,387
201107,gm. Sidra,podlaskie,3020,1311,1287,855,432
201108,gm. Sokółka,podlaskie,21123,10185,10046,5853,4193
201109,gm. Suchowola,podlaskie,5845,2600,2571,1652,919
201110,gm. Szudziałowo,podlaskie,2639,1204,1186,651,535
201201,gm. Bakałarzewo,podlaskie,2578,1198,1186,643,543
201202,gm. Filipów,podlaskie,3573,1540,1519,1003,516
201203,gm. Jeleniewo,podlaskie,2527,1285,1267,843,424
201204,gm. Przerośl,podlaskie,2458,1132,1117,765,352
201205,gm. Raczki,podlaskie,4734,2376,2350,1532,818
201206,gm. Rutka-Tartak,podlaskie,1997,964,959,614,345
201207,gm. Suwałki,podlaskie,5900,2975,2940,1639,1301
201208,gm. Szypliszki,podlaskie,3247,1452,1419,735,684
201209,gm. Wiżajny,podlaskie,2001,1036,1028,621,407
201301,m. Wysokie Mazowieckie,podlaskie,7548,4399,4345,2950,1395
201302,gm. Ciechanowiec,podlaskie,7376,3633,3584,2661,923
201303,gm. Czyżew,podlaskie,5267,2902,2864,2197,667
201304,gm. Klukowo,podlaskie,3663,2160,2143,1902,241
201305,gm. Kobylin-Borzymy,podlaskie,2750,1573,1561,1453,108
201306,gm. Kulesze Kościelne,podlaskie,2543,1639,1620,1516,104
201307,gm. Nowe Piekuty,podlaskie,3182,1996,1989,1725,264
201308,gm. Sokoły,podlaskie,4761,2692,2665,2295,370
201309,gm. Szepietowo,podlaskie,5759,3296,3262,2534,728
201310,gm. Wysokie Mazowieckie,podlaskie,4277,2404,2383,2014,369
201401,m. Zambrów,podlaskie,17699,8994,8869,5734,3135
201402,gm. Kołaki Kościelne,podlaskie,1940,1226,1213,1072,141
201403,gm. Rutki,podlaskie,4823,2504,2468,1901,567
201404,gm. Szumowo,podlaskie,3930,2168,2148,1714,434
201405,gm. Zambrów,podlaskie,7755,4148,4107,3064,1043
206101,m. Białystok,podlaskie,225348,132043,129863,66932,62931
206201,m. Łomża,podlaskie,48160,25777,25459,15751,9708
206301,m. Suwałki,podlaskie,53538,27938,27578,14409,13169
220101,gm. Borzytuchom,pomorskie,2343,1198,1183,485,698
220102,gm. Bytów,pomorskie,19077,10523,10403,4428,5975
220103,gm. Czarna Dąbrówka,pomorskie,4516,2304,2282,1107,1175
220104,gm. Kołczygłowy,pomorskie,3353,1498,1431,635,796
220105,gm. Lipnica,pomorskie,4182,2365,2342,1480,862
220106,gm. Miastko,pomorskie,15771,7072,6989,2758,4231
220107,gm. Parchowo,pomorskie,2726,1729,1706,843,863
220108,gm. Studzienice,pomorskie,2804,1502,1480,715,765
220109,gm. Trzebielino,pomorskie,2941,1253,1239,441,798
220110,gm. Tuchomie,pomorskie,3203,1546,1535,679,856
220201,m. Chojnice,pomorskie,31349,17410,17176,6922,10254
220202,gm. Brusy,pomorskie,10653,6358,6304,3555,2749
220203,gm. Chojnice,pomorskie,13617,7099,7015,2994,4021
220204,gm. Czersk,pomorskie,16450,8601,8538,4343,4195
220205,gm. Konarzyny,pomorskie,1765,941,934,407,527
220301,m. Człuchów,pomorskie,11428,6066,6000,2028,3972
220302,gm. Czarne,pomorskie,8494,3892,3828,1353,2475
220303,gm. Człuchów,pomorskie,8159,3381,3336,1442,1894
220304,gm. Debrzno,pomorskie,7251,3065,3018,1032,1986
220305,gm. Koczała,pomorskie,2801,1221,1205,379,826
220306,gm. Przechlewo,pomorskie,4891,2433,2408,803,1605
220307,gm. Rzeczenica,pomorskie,2981,1316,1301,586,715
220401,m. Pruszcz Gdański,pomorskie,21466,13132,12913,4688,8225
220402,gm. Cedry Wielkie,pomorskie,5141,2424,2401,951,1450
220403,gm. Kolbudy,pomorskie,11597,7128,7020,2481,4539
220404,gm. Pruszcz Gdański,pomorskie,18833,11219,11039,4092,6947
220405,gm. Przywidz,pomorskie,4413,2269,2236,890,1346
220406,gm. Pszczółki,pomorskie,6860,3728,3681,1501,2180
220407,gm. Suchy Dąb,pomorskie,3223,1441,1410,512,898
220408,gm. Trąbki Wielkie,pomorskie,8032,3705,3662,1626,2036
220501,gm. Chmielno,pomorskie,5587,3353,3311,1789,1522
220502,gm. Kartuzy,pomorskie,24597,14706,14486,7016,7470
220503,gm. Przodkowo,pomorskie,6167,3702,3658,1925,1733
220504,gm. Sierakowice,pomorskie,13410,8601,8543,5369,3174
220505,gm. Somonino,pomorskie,7461,3909,3860,1894,1966
220506,gm. Stężyca,pomorskie,7380,4470,4431,2412,2019
220507,gm. Sulęczyno,pomorskie,4102,2468,2452,1329,1123
220508,gm. Żukowo,pomorskie,24231,14947,14721,5973,8748
220601,m. Kościerzyna,pomorskie,18282,10321,10200,4301,5899
220602,gm. Dziemiany,pomorskie,3336,1976,1968,1242,726
220603,gm. Karsin,pomorskie,4834,2776,2752,1368,1384
220604,gm. Kościerzyna,pomorskie,11490,6673,6584,3382,3202
220605,gm. Liniewo,pomorskie,3605,1946,1929,965,964
220606,gm. Lipusz,pomorskie,2775,1653,1639,982,657
220607,gm. Nowa Karczma,pomorskie,4983,2649,2617,1221,1396
220608,gm. Stara Kiszewa,pomorskie,5164,2643,2598,1345,1253
220701,m. Kwidzyn,pomorskie,30048,15718,15464,6270,9194
220702,gm. Gardeja,pomorskie,6437,2466,2447,1195,1252
220703,gm. Kwidzyn,pomorskie,8449,3802,3743,1749,1994
220704,gm. Prabuty,pomorskie,10397,4580,4526,2113,2413
220705,gm. Ryjewo,pomorskie,4381,1898,1876,673,1203
220706,gm. Sadlinki,pomorskie,4450,1958,1935,1057,878
220801,m. Lębork,pomorskie,27108,14995,14785,5717,9068
220802,m. Łeba,pomorskie,3735,2193,2173,760,1413
220803,gm. Cewice,pomorskie,5307,2718,2665,1095,1570
220804,gm. Nowa Wieś Lęborska,pomorskie,10167,5234,5148,2255,2893
220805,gm. Wicko,pomorskie,4497,1882,1829,641,1188
220901,m. Malbork,pomorskie,30554,15835,15615,5676,9939
220903,gm. Lichnowy,pomorskie,3591,1555,1534,611,923
220904,gm. Malbork,pomorskie,3695,1731,1711,667,1044
220906,gm. Miłoradz,pomorskie,2707,1232,1222,495,727
220907,gm. Nowy Staw,pomorskie,5961,2544,2488,1130,1358
220908,gm. Stare Pole,pomorskie,3679,1585,1562,568,994
221001,m. Krynica Morska,pomorskie,1768,1249,1239,443,796
221002,gm. Nowy Dwór Gdański,pomorskie,14043,6415,6300,2411,3889
221003,gm. Ostaszewo,pomorskie,2514,1142,1136,485,651
221004,gm. Stegna,pomorskie,8176,3880,3819,1439,2380
221005,gm. Sztutowo,pomorskie,2988,1439,1417,481,936
221101,m. Hel,pomorskie,3148,1731,1709,509,1200
221102,m. Jastarnia,pomorskie,3951,2655,2627,1140,1487
221103,m. Puck,pomorskie,8955,5011,4948,1545,3403
221104,gm. Władysławowo,pomorskie,13066,8051,7943,2886,5057
221105,gm. Kosakowo,pomorskie,9414,6025,5915,2260,3655
221106,gm. Krokowa,pomorskie,8215,4630,4564,1978,2586
221107,gm. Puck,pomorskie,18575,10286,10122,4449,5673
221201,m. Ustka,pomorskie,14007,7814,7708,2886,4822
221202,gm. Damnica,pomorskie,4766,1986,1945,840,1105
221203,gm. Dębnica Kaszubska,pomorskie,7523,3221,3153,1208,1945
221204,gm. Główczyce,pomorskie,7204,2823,2794,1056,1738
221205,gm. Kępice,pomorskie,7199,3209,3172,1217,1955
221206,gm. Kobylnica,pomorskie,8491,3975,3915,1516,2399
221207,gm. Potęgowo,pomorskie,5461,2163,2132,819,1313
221208,gm. Słupsk,pomorskie,12411,6009,5878,2059,3819
221209,gm. Smołdzino,pomorskie,2720,1235,1227,544,683
221210,gm. Ustka,pomorskie,6471,3353,3294,1328,1966
221301,gm. Czarna Woda,pomorskie,2658,1470,1453,795,658
221302,m. Skórcz,pomorskie,2684,1528,1510,821,689
221303,m. Starogard Gdański,pomorskie,37201,19919,19677,9044,10633
221304,gm. Bobowo,pomorskie,2294,1114,1099,654,445
221305,gm. Kaliska,pomorskie,4134,2144,2118,1062,1056
221306,gm. Lubichowo,pomorskie,4970,2522,2478,1188,1290
221307,gm. Osieczna,pomorskie,2282,1278,1271,670,601
221308,gm. Osiek,pomorskie,2034,1144,1125,491,634
221309,gm. Skarszewy,pomorskie,10754,5497,5443,2702,2741
221310,gm. Skórcz,pomorskie,3532,1751,1721,1045,676
221311,gm. Smętowo Graniczne,pomorskie,4164,1975,1951,943,1008
221312,gm. Starogard Gdański,pomorskie,11667,6475,6389,3216,3173
221313,gm. Zblewo,pomorskie,8712,4388,4331,2222,2109
221401,m. Tczew,pomorskie,45886,25832,25512,10758,14754
221402,gm. Gniew,pomorskie,12258,5680,5609,2346,3263
221403,gm. Morzeszczyn,pomorskie,2836,1248,1237,588,649
221404,gm. Pelplin,pomorskie,12688,6202,6126,2769,3357
221405,gm. Subkowy,pomorskie,4117,2004,1961,907,1054
221406,gm. Tczew,pomorskie,10025,5326,5255,2314,2941
221501,m. Reda,pomorskie,17433,10603,10411,3881,6530
221502,m. Rumia,pomorskie,36177,22510,22129,8718,13411
221503,m. Wejherowo,pomorskie,37413,21758,21435,8711,12724
221504,gm. Choczewo,pomorskie,4540,2115,2084,706,1378
221505,gm. Gniewino,pomorskie,5323,2471,2433,990,1443
221506,gm. Linia,pomorskie,4511,2606,2579,1531,1048
221507,gm. Luzino,pomorskie,10666,6274,6205,3445,2760
221508,gm. Łęczyce,pomorskie,8767,4513,4450,2135,2315
221509,gm. Szemud,pomorskie,11829,7068,6971,3406,3565
221510,gm. Wejherowo,pomorskie,16925,9663,9540,4397,5143
221601,gm. Dzierzgoń,pomorskie,7405,3053,3017,1238,1779
221602,gm. Mikołajki Pomorskie,pomorskie,2848,1165,1158,595,563
221603,gm. Stary Dzierzgoń,pomorskie,3292,1226,1219,432,787
221604,gm. Stary Targ,pomorskie,5007,1932,1903,804,1099
221605,gm. Sztum,pomorskie,15281,7443,7300,2838,4462
226101,m. Gdańsk,pomorskie,358765,225387,221850,82228,139622
226201,m. Gdynia,pomorskie,191527,121668,119656,41031,78625
226301,m. Słupsk,pomorskie,73319,39502,38737,14531,24206
226401,m. Sopot,pomorskie,31280,20771,20437,6904,13533
229901,Statki Gdańsk,pomorskie,99,98,92,47,45
240101,m. Będzin,śląskie,45860,24764,24313,9371,14942
240102,m. Czeladź,śląskie,26680,14699,14449,5592,8857
240103,m. Wojkowice,śląskie,8332,4481,4404,1571,2833
240104,gm. Bobrowniki,śląskie,9714,5372,5278,2291,2987
240105,gm. Mierzęcice,śląskie,6171,3278,3224,1555,1669
240106,gm. Psary,śląskie,9638,5377,5295,2141,3154
240107,gm. Siewierz,śląskie,10123,5407,5323,2734,2589
240108,m. Sławków,śląskie,5709,3201,3158,1572,1586
240201,m. Szczyrk,śląskie,4767,2913,2891,1699,1192
240202,gm. Bestwina,śląskie,8979,5474,5412,2746,2666
240203,gm. Buczkowice,śląskie,8725,5263,5194,3002,2192
240204,gm. Czechowice-Dziedzice,śląskie,34804,21059,20769,10306,10463
240205,gm. Jasienica,śląskie,17881,11165,11006,5545,5461
240206,gm. Jaworze,śląskie,5719,3424,3389,1207,2182
240207,gm. Kozy,śląskie,9903,6180,6114,3150,2964
240208,gm. Porąbka,śląskie,12365,7488,7412,4457,2955
240209,gm. Wilamowice,śląskie,13214,8318,8199,5132,3067
240210,gm. Wilkowice,śląskie,11064,6572,6456,2990,3466
240301,m. Cieszyn,śląskie,28588,16196,15918,5860,10058
240302,m. Ustroń,śląskie,14989,9095,8974,3241,5733
240303,m. Wisła,śląskie,9365,5398,5326,832,4494
240304,gm. Brenna,śląskie,8779,4914,4838,2614,2224
240305,gm. Chybie,śląskie,7511,4390,4330,2537,1793
240306,gm. Dębowiec,śląskie,4535,2620,2586,1079,1507
240307,gm. Goleszów,śląskie,10370,5882,5800,1688,4112
240308,gm. Hażlach,śląskie,8192,4407,4339,2146,2193
240309,gm. Istebna,śląskie,9170,5471,5420,3711,1709
240310,gm. Skoczów,śląskie,20625,11624,11486,5341,6145
240311,gm. Strumień,śląskie,10069,5917,5844,3349,2495
240312,gm. Zebrzydowice,śląskie,10164,6013,5926,3392,2534
240401,gm. Blachownia,śląskie,10701,5613,5511,2430,3081
240402,gm. Dąbrowa Zielona,śląskie,3434,1690,1667,1045,622
240403,gm. Janów,śląskie,4910,2615,2576,1635,941
240404,gm. Kamienica Polska,śląskie,4609,2484,2455,1038,1417
240405,gm. Kłomnice,śląskie,11183,5735,5598,3450,2148
240406,gm. Koniecpol,śląskie,8247,4075,4011,2711,1300
240407,gm. Konopiska,śląskie,8753,4511,4453,1966,2487
240408,gm. Kruszyna,śląskie,4013,2101,2074,1362,712
240409,gm. Lelów,śląskie,4180,2203,2161,1507,654
240410,gm. Mstów,śląskie,8744,4727,4668,3023,1645
240411,gm. Mykanów,śląskie,11781,6639,6557,4012,2545
240412,gm. Olsztyn,śląskie,6529,3642,3579,1882,1697
240413,gm. Poczesna,śląskie,10375,5693,5587,2805,2782
240414,gm. Przyrów,śląskie,3233,1576,1551,979,572
240415,gm. Rędziny,śląskie,8110,4345,4277,2406,1871
240416,gm. Starcza,śląskie,2269,1245,1230,632,598
240501,m. Knurów,śląskie,30111,16522,16277,8387,7890
240502,m. Pyskowice,śląskie,14517,7062,6939,3112,3827
240503,gm. Gierałtowice,śląskie,9124,5588,5508,3078,2430
240504,gm. Pilchowice,śląskie,9088,4850,4775,2223,2552
240505,gm. Rudziniec,śląskie,8674,4035,3977,1808,2169
240506,gm. Sośnicowice,śląskie,6862,3342,3292,1285,2007
240507,gm. Toszek,śląskie,8036,3567,3507,1675,1832
240508,gm. Wielowieś,śląskie,4834,1932,1902,1003,899
240601,gm. Kłobuck,śląskie,16825,9327,9191,4675,4516
240602,gm. Krzepice,śląskie,7656,3998,3927,2222,1705
240603,gm. Lipie,śląskie,5281,2710,2672,1624,1048
240604,gm. Miedźno,śląskie,6247,3463,3395,2333,1062
240605,gm. Opatów,śląskie,5532,2692,2645,1490,1155
240606,gm. Panki,śląskie,4139,2052,2031,1071,960
240607,gm. Popów,śląskie,5047,2495,2453,1372,1081
240608,gm. Przystajń,śląskie,4834,2203,2173,1135,1038
240609,gm. Wręczyca Wielka,śląskie,14309,7202,7085,3641,3444
240701,m. Lubliniec,śląskie,19128,10662,10490,4971,5519
240702,gm. Boronów,śląskie,2762,1382,1364,784,580
240703,gm. Ciasna,śląskie,6870,2773,2738,1125,1613
240704,gm. Herby,śląskie,5816,3007,2957,1388,1569
240705,gm. Kochanowice,śląskie,5708,2639,2605,1545,1060
240706,gm. Koszęcin,śląskie,9534,5108,5055,2933,2122
240707,gm. Pawonków,śląskie,5306,2423,2376,1240,1136
240708,gm. Woźniki,śląskie,7780,4211,4170,2592,1578
240801,m. Łaziska Górne,śląskie,17226,9720,9571,5041,4530
240802,m. Mikołów,śląskie,31758,18919,18638,8460,10178
240803,m. Orzesze,śląskie,15817,9193,9070,5389,3681
240804,gm. Ornontowice,śląskie,4594,2702,2664,1698,966
240805,gm. Wyry,śląskie,5872,3639,3577,2045,1532
240901,m. Myszków,śląskie,26121,13320,13137,6588,6549
240902,gm. Koziegłowy,śląskie,11869,5823,5767,3278,2489
240903,gm. Niegowa,śląskie,4699,2519,2497,1845,652
240904,gm. Poraj,śląskie,8994,4769,4688,2162,2526
240905,gm. Żarki,śląskie,6898,3449,3398,2123,1275
241001,gm. Goczałkowice-Zdrój,śląskie,6031,3625,3568,1780,1788
241002,gm. Kobiór,śląskie,3872,2384,2363,1506,857
241003,gm. Miedźna,śląskie,12311,7296,7216,5201,2015
241004,gm. Pawłowice,śląskie,13749,8423,8311,5738,2573
241005,gm. Pszczyna,śląskie,40170,24551,24234,13413,10821
241006,gm. Suszec,śląskie,9054,5705,5621,3923,1698
241101,m. Racibórz,śląskie,43930,21846,21549,9285,12264
241102,gm. Kornowac,śląskie,4002,2186,2083,1238,845
241103,gm. Krzanowice,śląskie,4766,1800,1772,701,1071
241104,gm. Krzyżanowice,śląskie,9163,3577,3546,1488,2058
241105,gm. Kuźnia Raciborska,śląskie,9443,3718,3672,1581,2091
241106,gm. Nędza,śląskie,5922,2536,2505,1194,1311
241107,gm. Pietrowice Wielkie,śląskie,5545,2257,2234,961,1273
241108,gm. Rudnik,śląskie,4203,1667,1649,821,828
241201,gm. Czerwionka-Leszczyny,śląskie,32752,17844,17654,10465,7189
241202,gm. Gaszowice,śląskie,7367,4003,3943,2143,1800
241203,gm. Jejkowice,śląskie,3131,1898,1880,1127,753
241204,gm. Lyski,śląskie,7771,4460,4414,2277,2137
241205,gm. Świerklany,śląskie,9244,5619,5554,3744,1810
241301,m. Kalety,śląskie,7178,3636,3574,1910,1664
241302,m. Miasteczko Śląskie,śląskie,5769,2931,2888,1616,1272
241303,m. Radzionków,śląskie,13483,7822,7691,4173,3518
241304,m. Tarnowskie Góry,śląskie,49347,27531,27042,12178,14864
241305,gm. Krupski Młyn,śląskie,2692,1458,1437,802,635
241306,gm. Ożarowice,śląskie,4582,2673,2618,1409,1209
241307,gm. Świerklaniec,śląskie,9465,5078,5015,2458,2557
241308,gm. Tworóg,śląskie,6520,3184,3134,1644,1490
241309,gm. Zbrosławice,śląskie,12198,5721,5635,2467,3168
241401,m. Bieruń,śląskie,15440,8857,8744,5561,3183
241402,m. Imielin,śląskie,6818,4146,4059,2399,1660
241403,m. Lędziny,śląskie,13029,7489,7376,4887,2489
241404,gm. Bojszowy,śląskie,5913,3871,3829,2705,1124
241405,gm. Chełm Śląski,śląskie,4806,2864,2814,1777,1037
241501,m. Pszów,śląskie,11215,6054,5957,3537,2420
241502,m. Radlin,śląskie,13932,7534,7435,3833,3602
241503,m. Rydułtowy,śląskie,17126,9068,8959,4972,3987
241504,m. Wodzisław Śląski,śląskie,38417,21634,21358,11326,10032
241505,gm. Godów,śląskie,10730,6370,6265,3973,2292
241506,gm. Gorzyce,śląskie,16251,9042,8933,5093,3840
241507,gm. Lubomia,śląskie,6398,3157,3118,1848,1270
241508,gm. Marklowice,śląskie,4313,2594,2555,1628,927
241509,gm. Mszana,śląskie,5871,3636,3594,2665,929
241601,m. Poręba,śląskie,7151,3754,3673,1628,2045
241602,m. Zawiercie,śląskie,41659,21861,21546,10240,11306
241603,gm. Irządze,śląskie,2275,1092,1076,763,313
241604,gm. Kroczyce,śląskie,5202,2640,2587,1524,1063
241605,gm. Łazy,śląskie,13184,6979,6876,3407,3469
241606,gm. Ogrodzieniec,śląskie,7823,4108,4045,2138,1907
241607,gm. Pilica,śląskie,7324,4183,4127,2861,1266
241608,gm. Szczekociny,śląskie,6730,3674,3631,2413,1218
241609,gm. Włodowice,śląskie,4387,2294,2262,1219,1043
241610,gm. Żarnowiec,śląskie,3838,2107,2080,1512,568
241701,m. Żywiec,śląskie,25476,15217,14966,7594,7372
241702,gm. Czernichów,śląskie,5355,3418,3381,2267,1114
241703,gm. Gilowice,śląskie,4845,3039,3012,2038,974
241704,gm. Jeleśnia,śląskie,10863,6360,6308,4308,2000
241705,gm. Koszarawa,śląskie,2070,1165,1146,866,280
241706,gm. Lipowa,śląskie,8225,4800,4750,2641,2109
241707,gm. Łękawica,śląskie,3508,2105,2084,1420,664
241708,gm. Łodygowice,śląskie,11156,6699,6621,4120,2501
241709,gm. Milówka,śląskie,7996,4602,4548,3270,1278
241710,gm. Radziechowy-Wieprz,śląskie,10299,5985,5914,4189,1725
241711,gm. Rajcza,śląskie,7303,3734,3672,2398,1274
241712,gm. Ślemień,śląskie,2911,1728,1702,1272,430
241713,gm. Świnna,śląskie,6417,3764,3723,2306,1417
241714,gm. Ujsoły,śląskie,3748,1892,1874,1178,696
241715,gm. Węgierska Górka,śląskie,11841,7176,7083,4895,2188
246101,m. Bielsko-Biała,śląskie,136018,82852,81789,37564,44225
246201,m. Bytom,śląskie,128547,62713,61612,27793,33819
246301,m. Chorzów,śląskie,85232,43828,43102,16608,26494
246401,m. Częstochowa,śląskie,185216,105760,104136,48207,55929
246501,m. Dąbrowa Górnicza,śląskie,99036,54264,53337,22629,30708
246601,m. Gliwice,śląskie,144284,82107,80709,32389,48320
246701,m. Jastrzębie-Zdrój,śląskie,71673,40239,39678,24524,15154
246801,m. Jaworzno,śląskie,74457,40630,39983,19576,20407
246901,m. Katowice,śląskie,239995,140426,138060,56275,81785
247001,m. Mysłowice,śląskie,57961,33013,32547,16458,16089
247101,m. Piekary Śląskie,śląskie,44907,24235,23854,12161,11693
247201,m. Ruda Śląska,śląskie,109869,58541,57534,29569,27965
247301,m. Rybnik,śląskie,108887,60533,59586,31075,28511
247401,m. Siemianowice Śląskie,śląskie,54170,29276,28741,11236,17505
247501,m. Sosnowiec,śląskie,170838,92896,91338,37990,53348
247601,m. Świętochłowice,śląskie,39886,19326,19004,8399,10605
247701,m. Tychy,śląskie,100903,59235,58359,28505,29854
247801,m. Zabrze,śląskie,137609,64014,62754,27473,35281
247901,m. Żory,śląskie,47000,26790,26408,14286,12122
260101,gm. Busko-Zdrój,świętokrzyskie,28836,15110,14948,8459,6489
260102,gm. Gnojno,świętokrzyskie,3720,1714,1697,1293,404
260103,gm. Nowy Korczyn,świętokrzyskie,5180,2443,2413,1563,850
260104,gm. Pacanów,świętokrzyskie,6397,2694,2645,1790,855
260105,gm. Solec-Zdrój,świętokrzyskie,4363,2312,2284,1406,878
260106,gm. Stopnica,świętokrzyskie,6426,3087,3065,2117,948
260107,gm. Tuczępy,świętokrzyskie,3078,1460,1439,1075,364
260108,gm. Wiślica,świętokrzyskie,4764,2136,2106,1429,677
260201,gm. Imielno,świętokrzyskie,3704,1798,1785,1208,577
260202,gm. Jędrzejów,świętokrzyskie,23214,12271,12091,7257,4834
260203,gm. Małogoszcz,świętokrzyskie,9287,5053,5000,3890,1110
260204,gm. Nagłowice,świętokrzyskie,4167,1899,1880,1364,516
260205,gm. Oksa,świętokrzyskie,3876,1876,1852,1334,518
260206,gm. Sędziszów,świętokrzyskie,10492,5310,5230,3625,1605
260207,gm. Słupia (Jędrzejowska),świętokrzyskie,3612,1682,1665,1243,422
260208,gm. Sobków,świętokrzyskie,6839,3700,3639,2645,994
260209,gm. Wodzisław,świętokrzyskie,6077,2916,2887,2005,882
260301,gm. Bejsce,świętokrzyskie,3457,1356,1348,882,466
260302,gm. Czarnocin,świętokrzyskie,3334,1384,1365,904,461
260303,gm. Kazimierza Wielka,świętokrzyskie,13635,5975,5912,3711,2201
260304,gm. Opatowiec,świętokrzyskie,3078,1301,1293,758,535
260305,gm. Skalbmierz,świętokrzyskie,5485,2259,2245,1585,660
260401,gm. Bieliny,świętokrzyskie,7850,4178,4135,3334,801
260402,gm. Bodzentyn,świętokrzyskie,9371,4695,4645,3293,1352
260403,gm. Chęciny,świętokrzyskie,12328,6739,6641,4469,2172
260404,gm. Chmielnik,świętokrzyskie,9314,4781,4716,3345,1371
260405,gm. Daleszyce,świętokrzyskie,12308,6630,6544,4565,1979
260406,gm. Górno,świętokrzyskie,10826,6428,6353,4992,1361
260407,gm. Łagów,świętokrzyskie,5645,2697,2661,2071,590
260408,gm. Łopuszno,świętokrzyskie,7224,4049,3974,3053,921
260409,gm. Masłów,świętokrzyskie,8314,4945,4873,3009,1864
260410,gm. Miedziana Góra,świętokrzyskie,8794,5063,4966,3252,1714
260411,gm. Mniów,świętokrzyskie,7409,4062,4028,3144,884
260412,gm. Morawica,świętokrzyskie,12403,7011,6900,4394,2506
260413,gm. Nowa Słupia,świętokrzyskie,8154,3795,3758,2610,1148
260414,gm. Piekoszów,świętokrzyskie,12807,6992,6883,4982,1901
260415,gm. Pierzchnica,świętokrzyskie,3964,2022,1996,1418,578
260416,gm. Raków,świętokrzyskie,4847,2455,2423,1820,603
260417,gm. Sitkówka-Nowiny,świętokrzyskie,5739,3298,3246,1910,1336
260418,gm. Strawczyn,świętokrzyskie,8190,4709,4644,3552,1092
260419,gm. Zagnańsk,świętokrzyskie,10536,6331,6235,4175,2060
260501,gm. Fałków,świętokrzyskie,3871,1904,1890,1411,479
260502,gm. Gowarczów,świętokrzyskie,3869,1905,1880,1399,481
260503,gm. Końskie,świętokrzyskie,30143,16528,16310,9836,6474
260504,gm. Radoszyce,świętokrzyskie,7408,3844,3814,3035,779
260505,gm. Ruda Maleniecka,świętokrzyskie,2756,1566,1549,1086,463
260506,gm. Słupia (Konecka),świętokrzyskie,2787,1564,1544,1168,376
260507,gm. Smyków,świętokrzyskie,3022,1680,1666,1292,374
260508,gm. Stąporków,świętokrzyskie,14800,6950,6845,4111,2734
260601,gm. Baćkowice,świętokrzyskie,4098,2012,1988,1570,418
260602,gm. Iwaniska,świętokrzyskie,5607,2830,2796,2107,689
260603,gm. Lipnik,świętokrzyskie,4571,2012,1985,1358,627
260604,gm. Opatów,świętokrzyskie,9982,5213,5093,3172,1921
260605,gm. Ożarów,świętokrzyskie,8949,4376,4287,2413,1874
260606,gm. Sadowie,świętokrzyskie,3427,1600,1569,1089,480
260607,gm. Tarłów,świętokrzyskie,4660,2169,2135,1450,685
260608,gm. Wojciechowice,świętokrzyskie,3483,1660,1636,935,701
260701,m. Ostrowiec Świętokrzyski,świętokrzyskie,58066,28440,28030,14166,13864
260702,gm. Bałtów,świętokrzyskie,3091,1477,1456,814,642
260703,gm. Bodzechów,świętokrzyskie,11065,5238,5145,2889,2256
260704,gm. Ćmielów,świętokrzyskie,6261,2655,2602,1509,1093
260705,gm. Kunów,świętokrzyskie,8179,3794,3743,2225,1518
260706,gm. Waśniów,świętokrzyskie,5609,2367,2345,1814,531
260801,gm. Działoszyce,świętokrzyskie,4417,1896,1881,1219,662
260802,gm. Kije,świętokrzyskie,3737,1962,1945,1394,551
260803,gm. Michałów,świętokrzyskie,3895,1754,1733,1216,517
260804,gm. Pińczów,świętokrzyskie,18401,8830,8704,4991,3713
260805,gm. Złota,świętokrzyskie,3894,1634,1622,947,675
260901,m. Sandomierz,świętokrzyskie,20431,10756,10608,5353,5255
260902,gm. Dwikozy,świętokrzyskie,7367,3132,3088,1849,1239
260903,gm. Klimontów,świętokrzyskie,6797,3077,3040,2022,1018
260904,gm. Koprzywnica,świętokrzyskie,5641,3063,3021,2239,782
260905,gm. Łoniów,świętokrzyskie,6106,3147,3105,2276,829
260906,gm. Obrazów,świętokrzyskie,5449,2535,2499,1683,816
260907,gm. Samborzec,świętokrzyskie,7136,3530,3484,2227,1257
260908,gm. Wilczyce,świętokrzyskie,3192,1410,1384,799,585
260909,gm. Zawichost,świętokrzyskie,3734,1702,1640,980,660
261001,m. Skarżysko-Kamienna,świętokrzyskie,39099,20287,19994,10293,9701
261002,gm. Bliżyn,świętokrzyskie,6937,3398,3347,2090,1257
261003,gm. Łączna,świętokrzyskie,4217,2197,2165,1594,571
261004,gm. Skarżysko Kościelne,świętokrzyskie,5139,2783,2736,1767,969
261005,gm. Suchedniów,świętokrzyskie,8713,4620,4541,2495,2046
261101,m. Starachowice,świętokrzyskie,42020,21877,21537,10875,10662
261102,gm. Brody,świętokrzyskie,8918,4397,4336,2908,1428
261103,gm. Mirzec,świętokrzyskie,6810,3779,3717,2701,1016
261104,gm. Pawłów,świętokrzyskie,12149,6015,5952,4872,1080
261105,gm. Wąchock,świętokrzyskie,5826,3111,3065,1852,1213
261201,gm. Bogoria,świętokrzyskie,6397,3018,2987,2233,754
261202,gm. Łubnice,świętokrzyskie,3514,1795,1767,1423,344
261203,gm. Oleśnica,świętokrzyskie,3251,1581,1567,1090,477
261204,gm. Osiek,świętokrzyskie,6352,3385,3350,2866,484
261205,gm. Połaniec,świętokrzyskie,9679,5338,5278,3907,1371
261206,gm. Rytwiany,świętokrzyskie,5189,2529,2492,1826,666
261207,gm. Staszów,świętokrzyskie,21642,10550,10422,6553,3869
261208,gm. Szydłów,świętokrzyskie,3966,1964,1929,1318,611
261301,gm. Kluczewsko,świętokrzyskie,4311,2303,2280,1729,551
261302,gm. Krasocin,świętokrzyskie,8532,4519,4473,3300,1173
261303,gm. Moskorzew,świętokrzyskie,2383,1220,1203,893,310
261304,gm. Radków,świętokrzyskie,2148,964,945,600,345
261305,gm. Secemin,świętokrzyskie,4144,1990,1965,1205,760
261306,gm. Włoszczowa,świętokrzyskie,16554,9038,8907,6062,2845
266101,m. Kielce,świętokrzyskie,159105,95655,94151,46775,47376
280101,m. Bartoszyce,warmińsko-mazurskie,19643,10161,10032,4095,5937
280102,m. Górowo Iławeckie,warmińsko-mazurskie,3406,1640,1625,607,1018
280103,gm. Bartoszyce,warmińsko-mazurskie,8673,3743,3690,1780,1910
280104,gm. Bisztynek,warmińsko-mazurskie,5297,2078,2037,835,1202
280105,gm. Górowo Iławeckie,warmińsko-mazurskie,6807,2410,2378,760,1618
280106,gm. Sępopol,warmińsko-mazurskie,5251,2047,2018,807,1211
280201,m. Braniewo,warmińsko-mazurskie,13722,6952,6856,2738,4118
280202,gm. Braniewo,warmińsko-mazurskie,4958,2027,2005,800,1205
280203,gm. Frombork,warmińsko-mazurskie,3309,1520,1499,525,974
280204,gm. Lelkowo,warmińsko-mazurskie,2476,924,914,326,588
280205,gm. Pieniężno,warmińsko-mazurskie,5390,2236,2224,993,1231
280206,gm. Płoskinia,warmińsko-mazurskie,2075,862,858,380,478
280207,gm. Wilczęta,warmińsko-mazurskie,2435,892,880,409,471
280301,m. Działdowo,warmińsko-mazurskie,17241,9004,8911,3891,5020
280302,gm. Działdowo,warmińsko-mazurskie,7452,3102,3069,1478,1591
280303,gm. Iłowo-Osada,warmińsko-mazurskie,5695,2686,2653,1516,1137
280304,gm. Lidzbark,warmińsko-mazurskie,11560,5170,5086,2592,2494
280305,gm. Płośnica,warmińsko-mazurskie,4641,2058,2052,1058,994
280306,gm. Rybno,warmińsko-mazurskie,5753,2946,2920,1732,1188
280401,gm. Elbląg,warmińsko-mazurskie,5729,2436,2408,947,1461
280402,gm. Godkowo,warmińsko-mazurskie,2650,996,987,512,475
280403,gm. Gronowo Elbląskie,warmińsko-mazurskie,3978,1603,1589,598,991
280404,gm. Markusy,warmińsko-mazurskie,3181,1246,1229,538,691
280405,gm. Milejewo,warmińsko-mazurskie,2668,1214,1196,622,574
280406,gm. Młynary,warmińsko-mazurskie,3654,1614,1594,706,888
280407,gm. Pasłęk,warmińsko-mazurskie,15556,7192,7103,2815,4288
280408,gm. Rychliki,warmińsko-mazurskie,3170,1195,1176,467,709
280409,gm. Tolkmicko,warmińsko-mazurskie,5269,2254,2223,897,1326
280501,m. Ełk,warmińsko-mazurskie,45276,21472,21106,10733,10373
280502,gm. Ełk,warmińsko-mazurskie,8646,3459,3400,1686,1714
280503,gm. Kalinowo,warmińsko-mazurskie,5429,2098,2070,1080,990
280504,gm. Prostki,warmińsko-mazurskie,5870,2056,2020,1048,972
280505,gm. Stare Juchy,warmińsko-mazurskie,3120,1215,1200,586,614
280601,m. Giżycko,warmińsko-mazurskie,23949,12108,11940,4285,7655
280604,gm. Giżycko,warmińsko-mazurskie,6697,3185,3124,1215,1909
280605,gm. Kruklanki,warmińsko-mazurskie,2552,1072,1052,336,716
280606,gm. Miłki,warmińsko-mazurskie,3152,1306,1284,565,719
280608,gm. Ryn,warmińsko-mazurskie,4915,2182,2166,849,1317
280610,gm. Wydminy,warmińsko-mazurskie,5294,2310,2287,1056,1231
280701,m. Iława,warmińsko-mazurskie,27346,14599,14370,6059,8311
280702,m. Lubawa,warmińsko-mazurskie,7473,4267,4221,2009,2212
280703,gm. Iława,warmińsko-mazurskie,9720,4393,4350,2132,2218
280704,gm. Kisielice,warmińsko-mazurskie,4902,2030,2020,981,1039
280705,gm. Lubawa,warmińsko-mazurskie,8183,4256,4217,2635,1582
280706,gm. Susz,warmińsko-mazurskie,9916,4129,4068,1865,2203
280707,gm. Zalewo,warmińsko-mazurskie,5669,2069,2046,836,1210
280801,m. Kętrzyn,warmińsko-mazurskie,22497,11058,10904,4538,6366
280802,gm. Barciany,warmińsko-mazurskie,5314,1916,1891,747,1144
280803,gm. Kętrzyn,warmińsko-mazurskie,6563,2556,2511,1048,1463
280804,gm. Korsze,warmińsko-mazurskie,8516,3274,3248,1662,1586
280805,gm. Reszel,warmińsko-mazurskie,6522,2823,2765,1188,1577
280806,gm. Srokowo,warmińsko-mazurskie,3267,1374,1359,501,858
280901,m. Lidzbark Warmiński,warmińsko-mazurskie,12870,6628,6515,2590,3925
280902,gm. Kiwity,warmińsko-mazurskie,2782,1224,1198,585,613
280903,gm. Lidzbark Warmiński,warmińsko-mazurskie,5419,1966,1933,882,1051
280904,gm. Lubomino,warmińsko-mazurskie,2910,1139,1124,561,563
280905,gm. Orneta,warmińsko-mazurskie,9834,4328,4270,1919,2351
281001,m. Mrągowo,warmińsko-mazurskie,17402,9087,8976,4013,4963
281002,gm. Mikołajki,warmińsko-mazurskie,6905,3219,3178,1197,1981
281003,gm. Mrągowo,warmińsko-mazurskie,6237,2537,2493,1067,1426
281004,gm. Piecki,warmińsko-mazurskie,6283,2738,2704,1304,1400
281005,gm. Sorkwity,warmińsko-mazurskie,3707,1639,1613,687,926
281101,gm. Janowiec Kościelny,warmińsko-mazurskie,2639,1204,1189,769,420
281102,gm. Janowo,warmińsko-mazurskie,2182,1000,991,603,388
281103,gm. Kozłowo,warmińsko-mazurskie,4786,1899,1859,993,866
281104,gm. Nidzica,warmińsko-mazurskie,17065,8296,8178,3879,4299
281201,m. Nowe Miasto Lubawskie,warmińsko-mazurskie,8768,4508,4435,1982,2453
281202,gm. Biskupiec,warmińsko-mazurskie,7651,3530,3488,1619,1869
281203,gm. Grodziczno,warmińsko-mazurskie,4923,2435,2412,1584,828
281204,gm. Kurzętnik,warmińsko-mazurskie,6950,3461,3426,1876,1550
281205,gm. Nowe Miasto Lubawskie,warmińsko-mazurskie,6262,3072,3038,1703,1335
281303,gm. Kowale Oleckie,warmińsko-mazurskie,4172,1457,1449,671,778
281304,gm. Olecko,warmińsko-mazurskie,16978,8070,7975,3755,4220
281305,gm. Świętajno,warmińsko-mazurskie,3254,1232,1221,549,672
281306,gm. Wieliczki,warmińsko-mazurskie,2699,1169,1156,679,477
281401,gm. Barczewo,warmińsko-mazurskie,14038,6750,6670,2663,4007
281402,gm. Biskupiec,warmińsko-mazurskie,15283,6700,6600,2557,4043
281403,gm. Dobre Miasto,warmińsko-mazurskie,12792,6063,5946,2835,3111
281404,gm. Dywity,warmińsko-mazurskie,8563,4738,4676,1817,2859
281405,gm. Gietrzwałd,warmińsko-mazurskie,4975,2637,2571,1003,1568
281406,gm. Jeziorany,warmińsko-mazurskie,6386,2465,2428,1224,1204
281407,gm. Jonkowo,warmińsko-mazurskie,5477,2702,2669,1008,1661
281408,gm. Kolno,warmińsko-mazurskie,2747,1079,1061,501,560
281409,gm. Olsztynek,warmińsko-mazurskie,10957,5174,5111,2168,2943
281410,gm. Purda,warmińsko-mazurskie,6710,3011,2967,1171,1796
281411,gm. Stawiguda,warmińsko-mazurskie,6321,3664,3600,1285,2315
281412,gm. Świątki,warmińsko-mazurskie,3264,1300,1275,577,698
281501,m. Ostróda,warmińsko-mazurskie,26896,14194,13973,5201,8772
281502,gm. Dąbrówno,warmińsko-mazurskie,3434,1508,1492,722,770
281503,gm. Grunwald,warmińsko-mazurskie,4432,1691,1673,724,949
281504,gm. Łukta,warmińsko-mazurskie,3570,1459,1433,523,910
281505,gm. Małdyty,warmińsko-mazurskie,5067,1895,1876,706,1170
281506,gm. Miłakowo,warmińsko-mazurskie,4477,1806,1786,841,945
281507,gm. Miłomłyn,warmińsko-mazurskie,4075,1743,1719,672,1047
281508,gm. Morąg,warmińsko-mazurskie,19695,8978,8868,3612,5256
281509,gm. Ostróda,warmińsko-mazurskie,12303,5563,5469,2238,3231
281601,gm. Biała Piska,warmińsko-mazurskie,9411,3909,3864,2230,1634
281602,gm. Orzysz,warmińsko-mazurskie,7383,3098,3045,1299,1746
281603,gm. Pisz,warmińsko-mazurskie,21810,10262,10114,5541,4573
281604,gm. Ruciane-Nida,warmińsko-mazurskie,7060,3427,3383,1724,1659
281701,m. Szczytno,warmińsko-mazurskie,19835,10700,10525,5004,5521
281702,gm. Dźwierzuty,warmińsko-mazurskie,5413,2388,2359,1113,1246
281703,gm. Jedwabno,warmińsko-mazurskie,3101,1450,1423,625,798
281704,gm. Pasym,warmińsko-mazurskie,4326,1907,1882,834,1048
281705,gm. Rozogi,warmińsko-mazurskie,4531,1904,1846,1155,691
281706,gm. Szczytno,warmińsko-mazurskie,9518,4312,4248,2174,2074
281707,gm. Świętajno,warmińsko-mazurskie,4943,2229,2187,1130,1057
281708,gm. Wielbark,warmińsko-mazurskie,5155,2009,1949,1016,933
281801,gm. Banie Mazurskie,warmińsko-mazurskie,3276,1240,1229,462,767
281802,gm. Dubeninki,warmińsko-mazurskie,2486,918,906,460,446
281803,gm. Gołdap,warmińsko-mazurskie,16205,7091,6981,2700,4281
281901,gm. Budry,warmińsko-mazurskie,2450,908,895,378,517
281902,gm. Pozezdrze,warmińsko-mazurskie,2771,1134,1120,465,655
281903,gm. Węgorzewo,warmińsko-mazurskie,13988,6253,6189,2233,3956
286101,m. Elbląg,warmińsko-mazurskie,95165,49901,49182,20075,29107
286201,m. Olsztyn,warmińsko-mazurskie,134741,78542,77226,31117,46109
300101,m. Chodzież,wielkopolskie,15724,8897,8769,2735,6034
300102,gm. Budzyń,wielkopolskie,6562,3347,3287,1076,2211
300103,gm. Chodzież,wielkopolskie,4555,2481,2436,754,1682
300104,gm. Margonin,wielkopolskie,4920,2819,2789,1015,1774
300105,gm. Szamocin,wielkopolskie,5768,2917,2859,1144,1715
300201,m. Czarnków,wielkopolskie,8993,5151,5098,1799,3299
300202,gm. Czarnków,wielkopolskie,8695,4495,4436,1861,2575
300203,gm. Drawsko,wielkopolskie,4776,2492,2462,1171,1291
300204,gm. Krzyż Wielkopolski,wielkopolskie,7059,3329,3284,1312,1972
300205,gm. Lubasz,wielkopolskie,5772,2990,2946,1187,1759
300206,gm. Połajewo,wielkopolskie,4808,2531,2501,1077,1424
300207,gm. Trzcianka,wielkopolskie,18838,9626,9492,3709,5783
300208,gm. Wieleń,wielkopolskie,9915,5048,4983,2110,2873
300301,m. Gniezno,wielkopolskie,55188,30695,30284,12199,18085
300302,gm. Czerniejewo,wielkopolskie,6200,3258,3214,1550,1664
300303,gm. Gniezno,wielkopolskie,8238,4407,4337,1960,2377
300304,gm. Kiszkowo,wielkopolskie,4290,2193,2164,925,1239
300305,gm. Kłecko,wielkopolskie,5948,3167,3108,1628,1480
300306,gm. Łubowo,wielkopolskie,4755,2592,2558,1128,1430
300307,gm. Mieleszyn,wielkopolskie,3095,1448,1428,731,697
300308,gm. Niechanowo,wielkopolskie,4365,2275,2236,1178,1058
300309,gm. Trzemeszno,wielkopolskie,11227,5350,5255,2467,2788
300310,gm. Witkowo,wielkopolskie,10687,5758,5665,2602,3063
300401,gm. Borek Wielkopolski,wielkopolskie,6041,2780,2740,1277,1463
300402,gm. Gostyń,wielkopolskie,22342,11719,11563,5214,6349
300403,gm. Krobia,wielkopolskie,10275,4848,4793,2626,2167
300404,gm. Pępowo,wielkopolskie,4712,2532,2515,1298,1217
300405,gm. Piaski,wielkopolskie,6906,3435,3398,1712,1686
300406,gm. Pogorzela,wielkopolskie,4031,1873,1848,856,992
300407,gm. Poniec,wielkopolskie,6304,2730,2695,1350,1345
300501,gm. Granowo,wielkopolskie,3891,1987,1970,1000,970
300502,gm. Grodzisk Wielkopolski,wielkopolskie,15176,8055,7952,3244,4708
300503,gm. Kamieniec,wielkopolskie,5159,2590,2565,1024,1541
300504,gm. Rakoniewice,wielkopolskie,9908,4977,4920,1912,3008
300505,gm. Wielichowo,wielkopolskie,5376,2749,2712,1226,1486
300601,gm. Jaraczewo,wielkopolskie,6537,3364,3321,1850,1471
300602,gm. Jarocin,wielkopolskie,36091,19135,18857,8274,10583
300603,gm. Kotlin,wielkopolskie,5684,2932,2894,1472,1422
300604,gm. Żerków,wielkopolskie,8250,4173,4119,2298,1821
300701,gm. Blizanów,wielkopolskie,7820,3996,3951,1973,1978
300702,gm. Brzeziny,wielkopolskie,4648,2261,2217,1399,818
300703,gm. Ceków-Kolonia,wielkopolskie,3833,1838,1820,938,882
300704,gm. Godziesze Wielkie,wielkopolskie,7448,3843,3804,2263,1541
300705,gm. Koźminek,wielkopolskie,6023,2886,2836,1811,1025
300706,gm. Lisków,wielkopolskie,4230,2032,1993,1090,903
300707,gm. Mycielin,wielkopolskie,3997,1753,1718,980,738
300708,gm. Opatówek,wielkopolskie,8580,4782,4708,2790,1918
300709,gm. Stawiszyn,wielkopolskie,5798,2808,2766,1475,1291
300710,gm. Szczytniki,wielkopolskie,6244,3264,3230,2152,1078
300711,gm. Żelazków,wielkopolskie,7472,3951,3902,2282,1620
300801,gm. Baranów,wielkopolskie,6127,3485,3455,1723,1732
300802,gm. Bralin,wielkopolskie,4645,2690,2672,1229,1443
300803,gm. Kępno,wielkopolskie,19723,11162,11063,4504,6559
300804,gm. Łęka Opatowska,wielkopolskie,4141,2282,2245,1038,1207
300805,gm. Perzów,wielkopolskie,3071,1455,1437,706,731
300806,gm. Rychtal,wielkopolskie,3173,1504,1498,742,756
300807,gm. Trzcinica,wielkopolskie,3828,2044,2026,1040,986
300901,m. Koło,wielkopolskie,18269,9909,9757,4879,4878
300902,gm. Babiak,wielkopolskie,6468,3129,3062,2073,989
300903,gm. Chodów,wielkopolskie,2719,1289,1276,846,430
300904,gm. Dąbie,wielkopolskie,5345,2591,2555,1790,765
300905,gm. Grzegorzew,wielkopolskie,4521,2313,2288,1524,764
300906,gm. Kłodawa,wielkopolskie,10583,5430,5346,3226,2120
300907,gm. Koło,wielkopolskie,6005,3140,3096,1973,1123
300908,gm. Kościelec,wielkopolskie,5436,2776,2744,1807,937
300909,gm. Olszówka,wielkopolskie,3765,1707,1686,1205,481
300910,gm. Osiek Mały,wielkopolskie,4703,2406,2363,1644,719
300911,gm. Przedecz,wielkopolskie,3478,1554,1532,903,629
301001,gm. Golina,wielkopolskie,9584,4841,4776,2854,1922
301002,gm. Grodziec,wielkopolskie,4129,1852,1825,1062,763
301003,gm. Kazimierz Biskupi,wielkopolskie,9045,4831,4746,2971,1775
301004,gm. Kleczew,wielkopolskie,8012,4030,3964,2693,1271
301005,gm. Kramsk,wielkopolskie,8645,4488,4430,2978,1452
301006,gm. Krzymów,wielkopolskie,6030,3278,3232,2280,952
301007,gm. Rychwał,wielkopolskie,6656,3487,3454,2225,1229
301008,gm. Rzgów,wielkopolskie,5629,2862,2831,1700,1131
301009,gm. Skulsk,wielkopolskie,4923,2152,2125,1336,789
301010,gm. Sompolno,wielkopolskie,8350,4068,4013,2675,1338
301011,gm. Stare Miasto,wielkopolskie,8987,5130,5061,2946,2115
301012,gm. Ślesin,wielkopolskie,11411,5747,5687,3501,2186
301013,gm. Wierzbinek,wielkopolskie,5913,2903,2867,2112,755
301014,gm. Wilczyn,wielkopolskie,4922,2385,2354,1564,790
301101,m. Kościan,wielkopolskie,19686,11426,11264,3929,7335
301102,gm. Czempiń,wielkopolskie,9035,4657,4615,1807,2808
301103,gm. Kościan,wielkopolskie,12416,6563,6446,2725,3721
301104,gm. Krzywiń,wielkopolskie,7902,4059,4006,2196,1810
301105,gm. Śmigiel,wielkopolskie,13845,6841,6742,2968,3774
301201,m. Sulmierzyce,wielkopolskie,2220,1182,1160,546,614
301202,gm. Kobylin,wielkopolskie,6449,3102,3056,1405,1651
301203,gm. Koźmin Wielkopolski,wielkopolskie,10720,5457,5388,2482,2906
301204,gm. Krotoszyn,wielkopolskie,31828,17176,16986,7787,9199
301205,gm. Rozdrażew,wielkopolskie,3997,2105,2081,1317,764
301206,gm. Zduny,wielkopolskie,5756,2856,2807,1279,1528
301301,gm. Krzemieniewo,wielkopolskie,6702,3228,3179,1529,1650
301302,gm. Lipno,wielkopolskie,5614,2903,2867,1276,1591
301303,gm. Osieczna,wielkopolskie,7106,3603,3556,1590,1966
301304,gm. Rydzyna,wielkopolskie,6900,3589,3552,1506,2046
301305,gm. Święciechowa,wielkopolskie,5965,2816,2766,1180,1586
301306,gm. Wijewo,wielkopolskie,2875,1543,1521,636,885
301307,gm. Włoszakowice,wielkopolskie,7122,3592,3544,1418,2126
301401,gm. Chrzypsko Wielkie,wielkopolskie,2664,1260,1239,513,726
301402,gm. Kwilcz,wielkopolskie,4931,2423,2387,789,1598
301403,gm. Międzychód,wielkopolskie,14603,7418,7290,2453,4837
301404,gm. Sieraków,wielkopolskie,6953,3269,3214,1156,2058
301501,gm. Kuślin,wielkopolskie,4279,2157,2135,973,1162
301502,gm. Lwówek,wielkopolskie,7115,3517,3473,1353,2120
301503,gm. Miedzichowo,wielkopolskie,2967,1531,1510,610,900
301504,gm. Nowy Tomyśl,wielkopolskie,20129,11500,11365,3929,7436
301505,gm. Opalenica,wielkopolskie,12745,7147,7053,2775,4278
301506,gm. Zbąszyń,wielkopolskie,10633,6047,5919,1884,4035
301601,gm. Oborniki,wielkopolskie,26213,14515,14269,4961,9308
301602,gm. Rogoźno,wielkopolskie,13752,7136,7035,2625,4410
301603,gm. Ryczywół,wielkopolskie,5639,2963,2935,1123,1812
301701,m. Ostrów Wielkopolski,wielkopolskie,58781,33634,33183,12592,20591
301702,gm. Nowe Skalmierzyce,wielkopolskie,12147,6242,6163,3241,2922
301703,gm. Odolanów,wielkopolskie,11440,6394,6302,3978,2324
301704,gm. Ostrów Wielkopolski,wielkopolskie,14847,8061,7963,4364,3599
301705,gm. Przygodzice,wielkopolskie,9400,5352,5282,2748,2534
301706,gm. Raszków,wielkopolskie,9178,4774,4719,2727,1992
301707,gm. Sieroszewice,wielkopolskie,7678,3848,3789,2225,1564
301708,gm. Sośnie,wielkopolskie,5205,2538,2494,1341,1153
301801,gm. Czajków,wielkopolskie,2071,1013,993,595,398
301802,gm. Doruchów,wielkopolskie,4115,2154,2123,1086,1037
301803,gm. Grabów nad Prosną,wielkopolskie,6206,3248,3191,1719,1472
301804,gm. Kobyla Góra,wielkopolskie,4763,2555,2535,1074,1461
301805,gm. Kraszewice,wielkopolskie,2831,1423,1403,716,687
301806,gm. Mikstat,wielkopolskie,4931,2363,2329,1393,936
301807,gm. Ostrzeszów,wielkopolskie,18750,9962,9837,4242,5595
301901,m. Piła,wielkopolskie,57701,32967,32433,12739,19694
301902,gm. Białośliwie,wielkopolskie,3774,2005,1978,899,1079
301903,gm. Kaczory,wielkopolskie,6098,3388,3309,1495,1814
301904,gm. Łobżenica,wielkopolskie,7541,3885,3836,2187,1649
301905,gm. Miasteczko Krajeńskie,wielkopolskie,2545,1275,1257,573,684
301906,gm. Szydłowo,wielkopolskie,6726,3269,3223,1291,1932
301907,gm. Ujście,wielkopolskie,6395,3360,3313,1326,1987
301908,gm. Wyrzysk,wielkopolskie,10998,5377,5320,2565,2755
301909,gm. Wysoka,wielkopolskie,5320,2639,2619,1168,1451
302001,gm. Chocz,wielkopolskie,3794,1825,1800,911,889
302002,gm. Czermin,wielkopolskie,3811,2019,1991,1172,819
302003,gm. Dobrzyca,wielkopolskie,6506,3343,3299,1529,1770
302004,gm. Gizałki,wielkopolskie,3637,1767,1744,1010,734
302005,gm. Gołuchów,wielkopolskie,8240,4379,4327,2211,2116
302006,gm. Pleszew,wielkopolskie,23856,12454,12274,5084,7190
302101,m. Luboń,wielkopolskie,23145,14454,14253,4608,9645
302102,m. Puszczykowo,wielkopolskie,8042,5319,5241,1627,3614
302103,gm. Buk,wielkopolskie,9632,5702,5636,2277,3359
302104,gm. Czerwonak,wielkopolskie,20629,12715,12534,4148,8386
302105,gm. Dopiewo,wielkopolskie,16440,10935,10802,3254,7548
302106,gm. Kleszczewo,wielkopolskie,5311,3419,3372,1206,2166
302107,gm. Komorniki,wielkopolskie,17725,11514,11363,3162,8201
302108,gm. Kostrzyn,wielkopolskie,13659,7317,7202,2774,4428
302109,gm. Kórnik,wielkopolskie,17718,10922,10776,3737,7039
302110,gm. Mosina,wielkopolskie,23552,14313,14085,5099,8986
302111,gm. Murowana Goślina,wielkopolskie,13081,7574,7474,2397,5077
302112,gm. Pobiedziska,wielkopolskie,14831,8567,8415,2967,5448
302113,gm. Rokietnica,wielkopolskie,11095,6985,6897,2011,4886
302114,gm. Stęszew,wielkopolskie,11762,6198,6102,2312,3790
302115,gm. Suchy Las,wielkopolskie,11783,8218,8113,2432,5681
302116,gm. Swarzędz,wielkopolskie,35499,22040,21761,7249,14512
302117,gm. Tarnowo Podgórne,wielkopolskie,18303,12057,11866,3511,8355
302201,gm. Bojanowo,wielkopolskie,7013,3159,3111,1235,1876
302202,gm. Jutrosin,wielkopolskie,5503,2601,2583,1135,1448
302203,gm. Miejska Górka,wielkopolskie,7396,3523,3476,1685,1791
302204,gm. Pakosław,wielkopolskie,3662,1870,1854,808,1046
302205,gm. Rawicz,wielkopolskie,24452,12697,12505,4546,7959
302301,m. Słupca,wielkopolskie,11480,6473,6382,2798,3584
302302,gm. Lądek,wielkopolskie,4679,2355,2318,1283,1035
302303,gm. Orchowo,wielkopolskie,3092,1562,1541,795,746
302304,gm. Ostrowite,wielkopolskie,4215,1923,1904,1160,744
302305,gm. Powidz,wielkopolskie,1916,1006,995,473,522
302306,gm. Słupca,wielkopolskie,7519,3570,3489,2099,1390
302307,gm. Strzałkowo,wielkopolskie,7956,4219,4082,1952,2130
302308,gm. Zagórów,wielkopolskie,7189,3397,3351,1806,1545
302401,m. Obrzycko,wielkopolskie,1901,937,916,355,561
302402,gm. Duszniki,wielkopolskie,6823,3725,3675,1685,1990
302403,gm. Kaźmierz,wielkopolskie,6214,3309,3276,1120,2156
302404,gm. Obrzycko,wielkopolskie,3467,1547,1500,602,898
302405,gm. Ostroróg,wielkopolskie,3886,1910,1898,752,1146
302406,gm. Pniewy,wielkopolskie,9662,5242,5185,2045,3140
302407,gm. Szamotuły,wielkopolskie,23206,12791,12649,4369,8280
302408,gm. Wronki,wielkopolskie,16297,8878,8759,3040,5719
302501,gm. Dominowo,wielkopolskie,2280,1185,1173,534,639
302502,gm. Krzykosy,wielkopolskie,5350,2703,2670,1302,1368
302503,gm. Nowe Miasto nad Wartą,wielkopolskie,7111,3571,3521,1707,1814
302504,gm. Środa Wielkopolska,wielkopolskie,24832,13896,13630,5735,7895
302505,gm. Zaniemyśl,wielkopolskie,5260,2941,2880,1136,1744
302601,gm. Brodnica,wielkopolskie,3841,1899,1879,691,1188
302602,gm. Dolsk,wielkopolskie,4597,2135,2107,1027,1080
302603,gm. Książ Wielkopolski,wielkopolskie,6637,3270,3237,1607,1630
302604,gm. Śrem,wielkopolskie,32363,18026,17760,7313,10447
302701,m. Turek,wielkopolskie,22848,12893,12691,6617,6074
302702,gm. Brudzew,wielkopolskie,4749,2379,2341,1742,599
302703,gm. Dobra,wielkopolskie,5002,2373,2345,1581,764
302704,gm. Kawęczyn,wielkopolskie,4225,2088,2042,1442,600
302705,gm. Malanów,wielkopolskie,5122,2427,2384,1471,913
302706,gm. Przykona,wielkopolskie,3524,1822,1796,1267,529
302707,gm. Tuliszków,wielkopolskie,8392,4303,4228,2815,1413
302708,gm. Turek,wielkopolskie,6977,3649,3591,2335,1256
302709,gm. Władysławów,wielkopolskie,6408,3745,3692,2718,974
302801,m. Wągrowiec,wielkopolskie,19869,10988,10789,3766,7023
302802,gm. Damasławek,wielkopolskie,4338,2199,2161,1019,1142
302803,gm. Gołańcz,wielkopolskie,6551,3150,3115,1278,1837
302804,gm. Mieścisko,wielkopolskie,4713,2263,2204,962,1242
302805,gm. Skoki,wielkopolskie,7179,3621,3583,1298,2285
302806,gm. Wapno,wielkopolskie,2422,1084,1065,432,633
302807,gm. Wągrowiec,wielkopolskie,9119,4358,4298,1825,2473
302901,gm. Przemęt,wielkopolskie,11094,5436,5352,2320,3032
302902,gm. Siedlec,wielkopolskie,9620,5151,5084,1928,3156
302903,gm. Wolsztyn,wielkopolskie,23696,13530,13374,4609,8765
303001,gm. Kołaczkowo,wielkopolskie,4729,2364,2338,1227,1111
303002,gm. Miłosław,wielkopolskie,8263,4205,4148,1869,2279
303003,gm. Nekla,wielkopolskie,5735,3179,3132,1404,1728
303004,gm. Pyzdry,wielkopolskie,5723,2823,2786,1527,1259
303005,gm. Września,wielkopolskie,35521,19718,19417,8494,10923
303101,m. Złotów,wielkopolskie,14889,7927,7815,2911,4904
303102,gm. Jastrowie,wielkopolskie,9093,3997,3929,1546,2383
303103,gm. Krajenka,wielkopolskie,5858,2992,2950,1230,1720
303104,gm. Lipka,wielkopolskie,4362,1985,1959,773,1186
303105,gm. Okonek,wielkopolskie,6932,3108,3055,1218,1837
303106,gm. Tarnówka,wielkopolskie,2494,1184,1172,502,670
303107,gm. Zakrzewo,wielkopolskie,3887,1980,1943,834,1109
303108,gm. Złotów,wielkopolskie,7337,3168,3123,1230,1893
306101,m. Kalisz,wielkopolskie,81158,46880,46232,18361,27871
306201,m. Konin,wielkopolskie,61755,35904,35247,17114,18133
306301,m. Leszno,wielkopolskie,50091,27675,27269,9319,17950
306401,m. Poznań,wielkopolskie,421979,266536,262487,82860,179627
320101,m. Białogard,zachodniopomorskie,19153,9444,9312,3761,5551
320102,gm. Białogard,zachodniopomorskie,6180,2381,2351,940,1411
320103,gm. Karlino,zachodniopomorskie,7079,2887,2845,1330,1515
320104,gm. Tychowo,zachodniopomorskie,5879,2621,2596,930,1666
320201,gm. Bierzwnik,zachodniopomorskie,3948,1797,1790,700,1090
320202,gm. Choszczno,zachodniopomorskie,18090,8559,8464,3225,5239
320203,gm. Drawno,zachodniopomorskie,4267,1748,1718,655,1063
320204,gm. Krzęcin,zachodniopomorskie,3066,1225,1221,430,791
320205,gm. Pełczyce,zachodniopomorskie,6205,2417,2386,1042,1344
320206,gm. Recz,zachodniopomorskie,4508,1704,1669,745,924
320301,gm. Czaplinek,zachodniopomorskie,9500,4153,4089,1527,2562
320302,gm. Drawsko Pomorskie,zachodniopomorskie,13561,6199,6176,2349,3827
320303,gm. Kalisz Pomorski,zachodniopomorskie,5809,2504,2483,878,1605
320304,gm. Ostrowice,zachodniopomorskie,2032,885,878,406,472
320305,gm. Wierzchowo,zachodniopomorskie,3975,1812,1789,591,1198
320306,gm. Złocieniec,zachodniopomorskie,12326,5948,5888,2538,3350
320402,gm. Goleniów,zachodniopomorskie,28393,14533,14305,5420,8885
320403,gm. Maszewo,zachodniopomorskie,6807,2931,2897,1331,1566
320404,gm. Nowogard,zachodniopomorskie,20027,9592,9401,3618,5783
320405,gm. Osina,zachodniopomorskie,2300,997,979,483,496
320406,gm. Przybiernów,zachodniopomorskie,4004,1647,1614,738,876
320407,gm. Stepnica,zachodniopomorskie,3862,1564,1543,571,972
320501,gm. Brojce,zachodniopomorskie,2955,1033,1014,424,590
320502,gm. Gryfice,zachodniopomorskie,19358,9133,9006,3543,5463
320503,gm. Karnice,zachodniopomorskie,3283,1566,1551,718,833
320504,gm. Płoty,zachodniopomorskie,7429,3433,3387,1563,1824
320507,gm. Rewal,zachodniopomorskie,4299,2956,2921,1102,1819
320508,gm. Trzebiatów,zachodniopomorskie,13458,6286,6052,2443,3609
320601,gm. Banie,zachodniopomorskie,5114,2036,2016,869,1147
320602,gm. Cedynia,zachodniopomorskie,3584,1409,1397,429,968
320603,gm. Chojna,zachodniopomorskie,11009,4906,4842,1947,2895
320604,gm. Gryfino,zachodniopomorskie,24973,13185,12931,5586,7345
320605,gm. Mieszkowice,zachodniopomorskie,5799,2562,2535,1070,1465
320606,gm. Moryń,zachodniopomorskie,3468,1551,1530,641,889
320607,gm. Stare Czarnowo,zachodniopomorskie,3120,1556,1535,725,810
320608,gm. Trzcińsko-Zdrój,zachodniopomorskie,4504,1848,1816,836,980
320609,gm. Widuchowa,zachodniopomorskie,4365,1798,1752,782,970
320701,gm. Dziwnów,zachodniopomorskie,4218,2648,2618,906,1712
320702,gm. Golczewo,zachodniopomorskie,4827,2130,2111,889,1222
320703,gm. Kamień Pomorski,zachodniopomorskie,12238,5834,5761,2038,3723
320704,gm. Międzyzdroje,zachodniopomorskie,6022,3208,3166,1175,1991
320705,gm. Świerzno,zachodniopomorskie,3379,1317,1305,431,874
320706,gm. Wolin,zachodniopomorskie,9966,4571,4508,1770,2738
320801,m. Kołobrzeg,zachodniopomorskie,40403,23004,22715,8530,14185
320802,gm. Dygowo,zachodniopomorskie,4326,1931,1896,840,1056
320803,gm. Gościno,zachodniopomorskie,4054,1725,1692,695,997
320804,gm. Kołobrzeg,zachodniopomorskie,8801,4759,4704,1735,2969
320805,gm. Rymań,zachodniopomorskie,3321,1474,1455,615,840
320806,gm. Siemyśl,zachodniopomorskie,2946,1368,1355,570,785
320807,gm. Ustronie Morskie,zachodniopomorskie,4129,2624,2593,1151,1442
320901,gm. Będzino,zachodniopomorskie,6769,3071,3038,1256,1782
320902,gm. Biesiekierz,zachodniopomorskie,4925,2648,2595,897,1698
320903,gm. Bobolice,zachodniopomorskie,7653,3344,3300,1440,1860
320904,gm. Manowo,zachodniopomorskie,5252,2844,2796,977,1819
320905,gm. Mielno,zachodniopomorskie,5529,3716,3675,1519,2156
320906,gm. Polanów,zachodniopomorskie,7059,2903,2854,1260,1594
320907,gm. Sianów,zachodniopomorskie,10807,5198,5119,2073,3046
320908,gm. Świeszyno,zachodniopomorskie,5339,2894,2831,1025,1806
321001,gm. Barlinek,zachodniopomorskie,15419,7234,7123,3062,4061
321002,gm. Boleszkowice,zachodniopomorskie,2357,1028,1017,404,613
321003,gm. Dębno,zachodniopomorskie,16205,7650,7573,3185,4388
321004,gm. Myślibórz,zachodniopomorskie,16331,7449,7345,2888,4457
321005,gm. Nowogródek Pomorski,zachodniopomorskie,2711,1145,1139,462,677
321101,gm. Dobra (Szczecińska),zachodniopomorskie,14763,9339,9211,2692,6519
321102,gm. Kołbaskowo,zachodniopomorskie,8677,4635,4567,1442,3125
321103,gm. Nowe Warpno,zachodniopomorskie,1305,660,646,218,428
321104,gm. Police,zachodniopomorskie,31788,16860,16552,7147,9405
321201,gm. Bielice,zachodniopomorskie,2441,1066,1051,589,462
321202,gm. Kozielice,zachodniopomorskie,2137,944,937,514,423
321203,gm. Lipiany,zachodniopomorskie,4829,2097,2060,1073,987
321204,gm. Przelewice,zachodniopomorskie,4178,1715,1685,736,949
321205,gm. Pyrzyce,zachodniopomorskie,15513,7772,7668,3588,4080
321206,gm. Warnice,zachodniopomorskie,2856,1227,1211,701,510
321301,m. Darłowo,zachodniopomorskie,11591,5895,5820,2164,3656
321302,m. Sławno,zachodniopomorskie,10115,5155,5077,2258,2819
321303,gm. Darłowo,zachodniopomorskie,6900,3491,3442,1499,1943
321304,gm. Malechowo,zachodniopomorskie,5219,2340,2317,1123,1194
321305,gm. Postomino,zachodniopomorskie,6021,2982,2960,1299,1661
321306,gm. Sławno,zachodniopomorskie,6920,2850,2809,1340,1469
321401,m. Stargard Szczeciński,zachodniopomorskie,53746,29111,28663,11675,16988
321402,gm. Chociwel,zachodniopomorskie,4830,2162,2138,869,1269
321403,gm. Dobrzany,zachodniopomorskie,4124,1685,1650,751,899
321404,gm. Dolice,zachodniopomorskie,6335,2585,2549,1170,1379
321405,gm. Ińsko,zachodniopomorskie,2994,1232,1208,469,739
321406,gm. Kobylanka,zachodniopomorskie,4072,2352,2318,962,1356
321408,gm. Marianowo,zachodniopomorskie,2481,1095,1085,506,579
321409,gm. Stara Dąbrowa,zachodniopomorskie,2963,1204,1187,565,622
321410,gm. Stargard Szczeciński,zachodniopomorskie,9801,4476,4418,1935,2483
321411,gm. Suchań,zachodniopomorskie,3442,1299,1283,569,714
321501,m. Szczecinek,zachodniopomorskie,31664,16689,16423,7373,9050
321502,gm. Barwice,zachodniopomorskie,6864,2678,2651,1289,1362
321503,gm. Biały Bór,zachodniopomorskie,4264,1817,1783,804,979
321504,gm. Borne Sulinowo,zachodniopomorskie,7654,3473,3416,1467,1949
321505,gm. Grzmiąca,zachodniopomorskie,4072,1615,1598,666,932
321506,gm. Szczecinek,zachodniopomorskie,7301,2999,2965,1408,1557
321601,m. Świdwin,zachodniopomorskie,12111,5898,5843,2198,3645
321602,gm. Brzeżno,zachodniopomorskie,2258,886,875,346,529
321603,gm. Połczyn-Zdrój,zachodniopomorskie,13056,6124,6047,2505,3542
321604,gm. Rąbino,zachodniopomorskie,3000,1268,1249,608,641
321605,gm. Sławoborze,zachodniopomorskie,3356,1329,1304,537,767
321606,gm. Świdwin,zachodniopomorskie,4895,2032,2006,916,1090
321701,m. Wałcz,zachodniopomorskie,20232,10802,10613,3915,6698
321702,gm. Człopa,zachodniopomorskie,4054,1745,1722,674,1048
321703,gm. Mirosławiec,zachodniopomorskie,4220,1852,1824,668,1156
321704,gm. Tuczno,zachodniopomorskie,4038,1670,1656,632,1024
321705,gm. Wałcz,zachodniopomorskie,9829,4291,4199,1519,2680
321801,gm. Dobra,zachodniopomorskie,3545,1400,1381,597,784
321802,gm. Łobez,zachodniopomorskie,11115,5056,4966,1821,3145
321803,gm. Radowo Małe,zachodniopomorskie,2979,1177,1158,415,743
321804,gm. Resko,zachodniopomorskie,6321,2748,2684,1040,1644
321805,gm. Węgorzyno,zachodniopomorskie,5741,2381,2346,1064,1282
326101,m. Koszalin,zachodniopomorskie,85047,49275,48553,17802,30751
326201,m. Szczecin,zachodniopomorskie,307156,175704,172852,67821,105031
326301,m. Świnoujście,zachodniopomorskie,34069,17894,17618,6468,11150